scaffold_2	forward	CCCTAACCCTAACCCTAACCCTAACCCTAACCCTAACCCTAACCCTAACCTAACCCTAACCCTAACCCTAACCTAACCCTAACCCTAAGATGCACTTTCG
scaffold_5	forward	CCCTAACCCTAACCCTAACCCTAACCCTAACCCTAACCCTAACCCTAACCCTAACCCTAACCCTAACCATAACCCTAACCATAGCGCCAACGCAAGATTT
scaffold_8	reverse	GATCCTGCGGTTAGGGTTAGGGTTAGGGTTAGGGTTAGGGTTAGGGTTAGGGTTAGGGTTAGGGTTAGGGTTAGGGTTAGGGTTAGGGTTAGGGTTAGGG
scaffold_9	forward	CCCTAACCCTAACCCTAACCCTAACCCTAACCCTAACCCTAACCCTAACCCTAACCCTAACCCTAAGACTAGTCCGATCCCGGAACCGAAAGAGGCAACC
scaffold_10	forward	CCCTAACCCCTAACCCTAACCCTAACCCTAACCCTAACCCTAACCCTAACCCTAACCCTAACTTAACCCTAACCTAACCCTAAACCTAACCTATCCCCTC
scaffold_14	reverse	CTTAGGGTTAGGCTTAGGGTCAGGTTATGGATTAGGGGTAAAGGGTTAGGGTTAGGGTTAGGGTTAGGTTAGGGTTAGGGTTAGGGTTAGGGTTAGGGTT
scaffold_19	forward	CCCTAACCCTAACCCTAACCCTAACCCTAACCCTAACCCTAACCCTAACCCTAACCCTAACCCTAACCTTGGGCGAATTGAGGACCGGCTGCTGATGGCG
scaffold_23	forward	CCCTAACCCTACCCTAACCCTAACCCTACCCTAACCCTAACCCTAACCCTAACCCTAACCCTAACCCTAGCCCTAACCCTAACCCTAACTAACCCTAACC
scaffold_24	reverse	TCAGAGAGCGAGAAGGGTTAGGTTAGGGTTAGGGTTAGGGTTAGGGTTAGGGTTAGGGTTAGGGTTAGGGTTAGGGTTAGGGTTAGGGTTAGGGTTAGGG
scaffold_26	forward	ACCTAACCCTAACCTAACCCCCCTAACCTAACCTAACCCTAACCCTAACCCTAACCCTAACCCTAACCCTAACCCTAACCTAACCATAACCCTAACCTAA
scaffold_32	reverse	CGACGCTTGTCCGTTCAACGGAGCTCGAATTTGTGTTATGTTAGGGTTAGGGTTAGGGTTATGGTTAGGGTTAGGGTTAGGGTTAGGGTTAGGGTTAGGG
scaffold_34	forward	CCCTAACCCTAACCCTAACCCTAACCCTAACCCTAACCCTAACCTATCCTAACCCTAACCTAACCTACTTGCTGGGAAACAGCGTGCTCCACTTTCAGTC
scaffold_39	reverse	ATGACTATGCAGGGACCTGGGCGCAACCGAGAGGTTAGGGTTAGTGTTAGGGTTAGGGTTAGGGTTAGGGTTAGGGTTAGGGTTAGGGTTAGGGTTAGGG
scaffold_44	reverse	TGCGCTTTTTCCTCGCACCTGCTTCGGAAGGTTAGGTTAGGTTAGGGTTAGGGTAAGGGTTAGGTTAGGGTTAGGGTTAGGGTTAGGGTTAGGGTTAGGG
scaffold_46	reverse	ACTTGGTGAGTGTCAGTTGCAGGGTTAGGTTAGGGTTAGGTTAGGGTTAGGGTTAGGGTTAGGGTTAGGGTTAGGGTTAGGGTTAGGGTTAGGGTTAGGG
scaffold_49	forward	CCCTAACCCTAACCCTAACCCTAACCCTAACCCTAACCCTAACCCTAACCCTAACCCTAACCTAACCGAGTCGTAGGGAGGGCAAGTTGGGCGTGCGAAG
scaffold_51	reverse	TGCTCGTGGCTACACTCAGATGGTTAGGGTTAGGTTAGGGTTAGGGTTAGGGTTAGGGTTAGGGTTAGGGTTAGGGTTAGGGTTAGGGTTAGGGTTAGGG
scaffold_52	reverse	CCGTACTATGTGTCTCTGCTGGATCTTAGGGTTAGGTTAGGGTTAGGTTAGGTTTAGGTTAGGGTTAGGGTTAGGGTTAGGGTTAGGGTTAGGGTTAGGG
scaffold_55	reverse	GCAGCTCAGAGCTTAGGGTTAGGTTAGGGTTAGGTTAGGGTTAGGGTCAGGGTTAGGGTTAGGGTTAGGGTTAGGGTTAGGGTTAGGGTTAGGGTTAGGG
scaffold_56	forward	CCCTAACCCTAACCCTAACCTAACCCTAACCCTAACCCTAACCCTAACCCTAACCTAACCTAACCAACGAGGGTCCAGACTGTGGCCCTAGCAGAATCGG
scaffold_58	reverse	GGGAACAGTTGTCAGTGTCGAAGGGTTAGGTTAGGGTTAGGTTAGGGTTAGGGTTAGGGTTAGGGTTAGGGTTAGGGTTAGGGTTAGGGTTAGGGTTAGG
scaffold_61	forward	CCCTAACCCTAACCCTAACCCTAACCCTAACCCTAACCCTAACCCTAACCCTAACCCTAACCCTAACCCTAACCCTTATCGAAAGCTCGGATCCGTCGTC
scaffold_65	reverse	GGTGTACAGTACTCGGTTAGGGTTAGGGTTAGGGTTAGGGTTAGGTTAGGGTTAGGGTTAGGGTTAGGGTTAGGGTTAGGGTTAGGGTTAGGGTTAGGGT
scaffold_69	reverse	TTGTCGCGTTCTTCCGCAAGCACTGCGTTTGTTAGGGTTAGGTTAGGGTTAGGTTAGGGTTAGGGTTAGGGTTAGGTTAGGGTTAGGGTTAGGGTTAGGG
scaffold_71	reverse	CGACGGGTCTCCTCAGCCAGAGATGCTAGGTTAGGTTAGGTTAGGGTTAGGGTTAGGGTTAGGGTTAGGGTTAGGGTTAGGGTTAGGGTTAGGGTTAGGG
scaffold_78	reverse	CGCGCCATTGCATCTCGCGCGTCTCCTCAATCTCTTAGGGTTAGGGTTAGGTTAGGGTTAGGGTTAGGGTTAGGGTTAGGGTTAGGGTTAGGGTTAGGGT
scaffold_81	reverse	CTCGCTATGCTTGGAATGCACTCAAAACTTAGGGTTAGGGTTAGGGTTAGGGTTAGGGTTAGGGTTAGGGTTAGGGTTAGGGTTAGGGTTAGGGTTAGGG
scaffold_85	reverse	GCGCGCTCCGCATGAACGACCGTCTTAGGGTTAGGGTTAGGTTAGGGTTAGGTTAGGGTTAGGGTTAGGGTTAGGGTTAGGGTTAGGGTTAGGGTTAGGG
scaffold_88	forward	CCCTAACCCTAACCCTAACCCTAACCCTAACCCTAACCTAACCCTAACCTAACCCTAACCCTAACCTAACCCTGGCGCCTCGACTTGCTCGGGATCAAGT
scaffold_89	forward	CCCTAACCCTAACCCTAACCCTAACCCTAACCCTAACCCTAACCCTAACCCTAACCCTAACCCTAACCCTAACCCTAACCCTAACCCTAACCCTAACCCT
scaffold_92	reverse	GATCAAGACATTTAGGTTAGGGTTAGGGTTAGGGTTAGGGTTAGGGTTAGGGTTAGGGTTAGGGTTAGGGTTAGGGTTAGGGTTAGGGTTAGGGTTAGGG
scaffold_94	reverse	GCGAATAGAAGCGTTTGTACGCCTGTTAGGTTAGGGTTAGGTTAGGGTTAGGTTAGGGTTAGGGTTAGGGTTAGGGTTAGGGTTAGGGTTAGGGTTAGGG

Telomeres found: 32 (13 forward, 19 reverse)
