scaffold_1	reverse	GCCACGGACGCCAGCGGCCGTCAAAGGAGCGCAGACGGTTAGGTTATGTTAGGTTAGGGTTAGGTTAGGGTTAGGATTAGGGTTAGGGTTAGGGTTAGGG
scaffold_2	reverse	CTAGTGAAAACCGTGGCATTGCATAGACTGGGTTAGGTTAGGTTAGGGTTAGGTTAGGGTTAGGTTAGGGTTAGGGTTAGGGTTAGGGTTAGGGTTAGGG
scaffold_4	forward	CCCTAACCCTAACCCTAACCCTAACCCTAACCCTAACCCTAACCCTAACCCTAACCCTAACCCTAACCCTAACCATAGCGCCAACGCAAGATTTACACTA
scaffold_5	reverse	CGACTTGAAGGTTAGGGGTTAGGTTAGGGTTAGGTTAGGGTTAGGGTTAGGGTTAGGGTTAGGGTTAGGGTTAGGGTTAGGGTTAGGGTTAGGGTTAGGG
scaffold_10	reverse	CGCCTTAGGTTAGGGTTAGGGTTTAGGGTTAGGTTAGGGTTAGGGTTAGGGTTAGGGTTAGGGTTAGGGTTAGGGTTAGGGTTAGGGTTAGGGTTAGGGG
scaffold_12	forward	ACCCTAACCCTAACCCTAACCCTAACCCTAACCCTAACCCTAACCCTAACCCTAACCTAACCCTTCAGCTCCATGTGCACTTCCTCTCCATTTCCCTTCG
scaffold_16	reverse	GGTTAGGTTAGTGTTAGGGTTAGGTTAGGTTAGAGTTAGGTTAGGGTTAGGGTTAGGGTTAGGGTTAGGGTTAGGGTTAGGGTTAGGGTTAGGGTTAGGG
scaffold_17	forward	CCCTAACCCTAACCCTAACCTAACCTAACCCTAACCCTAACCCTAACCCTAACCCTAACCCTAGCCCTAACCTAACCCTAACCCTAACCCTTGCAGGCCA
scaffold_19	forward	CCCTAACCCTAACCCTAACCCTAACCCTAACCCTAACCCTAACCCTAACCCTAACCTAACCCTAACCCTAACCCTACCACCTAACCCCCAGAGAAGAACG
scaffold_32	reverse	GGAATGCACTCAAAACTTAGGGTTAGGGTTAGGGTTAGGGTTAGGGTTAGGGTTAGGGTTAGGGTTAGGGTTAGGGTTAGGGTTAGGGTTAGGGTTAGGG
scaffold_33	reverse	CCAGGTTAGGTTAGGGTTTAGGTTTAGGGTTAGGGTTAGGGTTAGGGTTAGGTTAGGATTAGGGTTAGGGTTAGGGTTAGGGTTAGGGTTAGGGTTAGGG
scaffold_35	forward	ACCCTAACCCTAACCCTAACCCTAACCCTAACCCTAACCCTAACCCTAACCCTAAACTCTAACCCTAATCCTAACATAACCCTAACCCTAACCACTTTCA
scaffold_37	forward	TAACCCTAACCCTAACCCTAACCCTAACCCTAACCCTAACCCTAACCCTAACCCTAACCCTAACCCTAACCCTAAGCTCTCAAAATTCAGCACTTGGCCC
scaffold_42	forward	CCCTAACCCTAACCCTAACCCTAACCCTAACCCTAACCCTAACCCTAACCCTAACCCTAACCCTAACCCTAACCCTAAGCCAGTCCTGCCATGGAAAATG
scaffold_44	reverse	GCTCTCGCGAGTGATCGGTTAGGTTAGGTTAGGGTTAGGGTTAGGGCTAGGGTTAGGGTTAGGGTTAGGGTTAGGGTTAGGGTTAGGGTTAGGGTTAGGG
scaffold_46	forward	CCCTAACCCTAACCCTAACCCTAACCCTAACCCTAACCCTAACCCTAACCCTAACCCTAACCCTAACCCTAACCTAACCCTAAGTACAGCTCGTGGACTG
scaffold_54	forward	ACCCTAACCCTAACCCTAACCCTAACCCTAACCCTAACCCTAACCCTAACCCTAACCCTAACCCTAACCCTAACCCTCTCCATTTCCTTTGGAATTCCCT
scaffold_57	reverse	GTAACAGCAGCCGGGCAGCTGCTGTCGATAGGGTTAGGTTAGGGTTAGGGTTAGGGTTAGGGTTAGGGTTAGGGTTAGGGTTAGGGTTAGGGTTAGGGTT
scaffold_65	forward	CCCTAACCCTAACCCTAACCCTAACCCTAACCCTAACCCTAACCCTAACCCTAACCCTAACCCTAACCCTAACCCTAACCTAACCCTAACCTTAACAATA
scaffold_66	forward	ACCCTAACCCTAACCCTAACCCTAACCCTAACCCTAACCCTAACCCTAACCCTAACCTAACCCTAACCCTAACCCCTAACCCTGAGTCCCAGAATTGGCC
scaffold_70	forward	CCCTAACCCTAACCCTAACCCTAACCCTAACCCTAACCCTAACCCTAACCCTAACCCTAACCCTAACCCTAACCCTAACCCTAACATAAACCTAACCCAA
scaffold_81	reverse	GTAAGGAAGCCTTTCAGAGACGACATGTATGGCAGGTTAGGTTAGGGTTAGGTTAGGGTTAGGGTTAGGGTTAGGGTTAGGGTTAGGGTTAGGGTTAGGG
scaffold_83	reverse	CTCTGAGGCGCTTTCGATCTTAGGGTTAGGTTAGGGTTAGGGTTAGGTTAGGGTTAGGTTAGGGTTAGGGTTAGGGTTAGGGTTAGGGTTAGGGTTAGGG
scaffold_87	reverse	ACGATCGGCAAGGCGATGCGTGCGTTTTCTTAGGGTTAGGGTTAGGGTTAGGTTAGGGTTAGGGTTAGGGTTAGGGTTAGGGTTAGGGTTAGGGTTAGGG
scaffold_91	forward	ACCCTAACCCTAACCCTAACCCTAACCCTAACCTAACCCTAACCCTAACCTAACATAACCCTAACCTAACCCTAAGCTTGCTCGCCTGTTTCGCAAGGAA
scaffold_93	reverse	GTTACTTAGGGTTAGGGTTAGGTTAGGGTTAGGGTTAGGGTTAGGGTTAGGGTTAGGGTTAGGGTTAGGGTTAGGGTTAGGGTTAGGGTTAGGGTTAGGG
scaffold_95	forward	CCCTAACCCTAACCCTAACCCTAACCCTAACCCTAACCCTAACCCTAACCCTAACCCTAACCCTAACCTAACCCTAATGTGTGGCCACACCTATCACGAC
scaffold_96	forward	ACCCTAACCCTAACCCTAACCCTAACCCTAACCCTAACCCTAACCCTAACCCTAACCCTAACCCTAACATGCGGCGAGAGACCTGCTCTTCGTTCGTCGG
scaffold_105	reverse	TAGGGTTAGGTTAGGGTTAGGGTTAGGGTTAGGGTTAGGGTTAGGGTTAGGGTTAGGGTTAGGGTTAGGGTTAGGGTTAGGGTTAGGGTTAGGGTTAGGG
scaffold_106	forward	CCCTAACCCTAACCCTAACCCTAACCCTAACCCTAACCCTAACCTTAACCCTAACCCTAACCTTAGCCTAACCCTAACCCTAACCTAACCCTCGATTCTG
scaffold_107	reverse	AACGTCGTCGGACCCGTCGGCCACCTTCTTAGGGTTAGGGTTAGGGTTAGGGTTAGGGTTAGGGTTAGGGTTAGGGTTAGGGTTAGGGTTAGGGTTAGGG
scaffold_111	forward	CCCTAACCCTAACCCTAACCCTAACCTAACCCTAACCCTAACCCTAACCTAACCCTAACCTAACCCTAACCCTAAGCAGATACTTTACAGGCAACCACAA
scaffold_124	forward	CCCTAACCCTAACCCTAACCCTAACCCTAACCCTAACCCTAACCCTAACCCTAACCCTAACCTAACCCTAACCCTAAAGCATCCACCAGGGACCGAGCCA

Telomeres found: 33 (18 forward, 15 reverse)
