scaffold_1	forward	CCCTAACCCTAACCCTAACCCTAACCCTAACCCTAACCCTAACCTAACCCTAACCCTAACCCTAACCCTAAACCGGTCAAAAAAGCACCCACTCGGTGCG
scaffold_4	reverse	GTGAGCAGGGCGGAGGGCGGACCGGACACTTAGGGTTAGGTTAGGGTTAGGGTTAGGGTTAGGGTTAGGGTTAGGGTTAGGGTTAGGGTTAGGGTTAGGG
scaffold_6	reverse	CGGACAGGTTTGAAGCTAGTCACCGCTGATCTGTCTTAGGGTTAGGGTTAGGGTTAGGTTAGGGTTAGGGTTAGGGTTAGGGTTAGGGTTAGGGTTAGGG
scaffold_7	reverse	TTTCATTTCCACACATGCACCAAGGTCTGCTGGCTTAGGGTTAGGGTTAGGGTTAGGGTTAGGGTTAGGGTTAGGGTTAGGGTTAGGGTTAGGGTTAGGG
scaffold_14	reverse	TTGTGCACCCGTTAGGTTAGGGTTAGGGTTAGGGTTAGAGTTAGGGTTAGGGTTAGGGTTAGGGTTAGGGTTAGGGTTAGGGTTAGGGTTAGGGTTAGGG
scaffold_18	reverse	TACACTCGAATGCTCAAAGGGAGAGATCTCCTTCAAAAGGTTAGGGTTAGGGTTAGGGTTAGGGTTAGGGTTAGGGTTAGGGTTAGGGTTAGGGTTAGGG
scaffold_22	forward	CCCTAACCCTAACCCTAACCCTAACCCTAACCCTAACCCTAACCCTAACCCTAACCCTAACCTAACCCTAACCCTAACCCAATCTTCTTTCCGAAGCTTG
scaffold_23	forward	CCCTAACCCTAACCCTAACCCTAACCCTAACCCTAACCTAACCCTAACCCTAACCCTAACCCAAGCGCGTGGGTCTCGGGTCAAGCTGACGCCACTTCCG
scaffold_27	forward	CCCTAACCCTAACCCTAACCCTAACCCTAACCCTAACCCTAACCCTAACCCTAACCCTAACCCTAACCTAAGAGAGAGGTCGCGCTACTCGCGGCCTTTT
scaffold_29	forward	CCCTAACCCTAACCCTAACCCTAACCCTAACCCTAACCCTAACCCTAACCCTAATCTAACTCTGAGCCTAACCCTAACCCTAACCCTAAACCAATGAGCA
scaffold_30	reverse	TATGATAGCCTTTCGCAAGGCAATGGTACTGCTGTTAGGGTTAGGGTTAGGGTTAGGGTTAGGGTTAGGGTTAGGGTTAGGGTTAGGGTTAGGGTTAGGG
scaffold_35	forward	CCCTAACCCTAACCCTAACCCTAACCCTAACCCTAACCCTAACCCTAACCCTAACCCTAACCCTAACCTAACCCTAACCATAACCCTAAGGATCCCCTCG
scaffold_41	forward	AACCCTAACCCTAACCCTAACCCTAACCCTAACCCTAACCCTAACCCTAACCCTAACCCTAACCTAACCCTAACCCTAACCCTAAGTGGAAGCTGAAGAC
scaffold_42	reverse	GGGTTAGGGTTAGTGTTTAGGGTTAGGGTTAGGGTTAGGGTTAGGGTTAGGGTTAGGGTTAGGGTTAGGGTTAGGGTTAGGGTTAGGGTTAGGGTTAGGG
scaffold_44	forward	ACCCTAACCCTAACCCTAACCCTAACCCTAACCCTAACCCTAACCCTAACCCTAACCCTAACCCTAACCCAGATTAGTGTTTCGGGCAAGCGTCAAGTTT
scaffold_55	reverse	GGGTTAGGGTTAGGGTTAGGGTTAGGGTTAGGGTTAGGGTTAGGGTTAGGGTTAGGGTTAGGGTTAGGGTTAGGGTTAGGGATATCTATAATAAACATCA
scaffold_56	reverse	ACGCCTGTCGGGCGAGAACTGCGGAACTGGTCAGCAAGGGTTAGGGTTAGGGTTAGGGTTAGGGTTAGGGTTAGGGTTAGGGTTAGGGTTAGGGTTAGGG
scaffold_59	reverse	CATCCCGCAAGCTCTACTTTGCTTAGGGTTAGGGTTAGGGTTAGGGTTAGGGTTAGGGTTAGGGTTAGGGTTAGGGTTAGGGTTAGGGTTAGGGTTAGGG
scaffold_62	reverse	AGATAGGGACCTTTTCTGAGGCAGATCACTTAGGTTAGGTTAGGGTTAGGGTTAGGGTTAGGGTTAGGGTTAAGGGTTAGGGTTAGGGTTAGGGTTAGGG
scaffold_63	reverse	GTCAAGTATGTCGAGGGGTTAGGGTTAGGTTAGGTTAGGGTTAGGGTTAGGGTTAGGGTTAGGGTTAGGGTTAGGGTTAGGGTTAGGGTTAGGGTTAGGG
scaffold_70	reverse	GCGGAGTGGTCAAGGCGAGCTTCGCGGTTAGGTTAGGGTTAGGGTTAGGGTTAGGGTTAGGGTTAGGGTTAGGGTTAGGGTTAGGGTTAGGGTTAGGGTT
scaffold_74	forward	CCCTAACCCTAACCCTAACCCTAACCCTAACCCTAACCCTAACCCTAACCCTAACCTAACCCTAGGCGGGCATTCACCCGAAGCAGCGACATCAACAGTG
scaffold_81	reverse	TGCAAAGATTCTCTGGCGCTCGCGACCAACGCGTGTCAAGGGTTAGGTTAGGGTTAGGGTTAGGTTAGGGTTAGGGTTAGGGTTAGGGTTAGGGTTAGGG
scaffold_83	forward	CCCTAACCCTAACCCTAACCCTAACCCTAACCCTAACCCTAACCCTAACCCTAACCTAACCCTAACCTCTCTCGGACATCGCCAAATAGCCTTGAACACT
scaffold_84	forward	CCCTAACCCTAACCCTAACCCTAACCCTAACCATAACCCTAACCCTAACCCTAACCCTAACCCTAACCAAACTTTTGAGTAGTCCAAGGCCTAACCTACA
scaffold_86	forward	CCCTAACCCTAACCCTAACCCTAACCCTAACCCTAACCCTAACCCTAACCCTAACCTAACCCTTTTCCACCTCTCCTCTCCGCAACATGGCCCTAGGGGA
scaffold_88	forward	CCCTAACCCTAACCCTAACCCTAACCCTAACCCTAACCCTAACCCTAACCCTAACCCTGTCCATTCCGCCATACCCACGGCTCAAGCTGGCCTTGGGACT
scaffold_90	reverse	TACTGCAGGGCAGCTTAGGGTTAGGTTAGGGTTAGGTTAGGGTTAGGGTTAGGGTTAGGGTTAGGGTTAGGGTTAGGGTTAGGGTTAGGGTTAGGGTTAG
scaffold_91	forward	ACCCTAACCCTAACCCTAACCCTAACCCTAACCCTAACCCTAACCCTAACCCTAACCCTAACCCTAACCTCAAAAGCGAAATCTTCGATGCAAATCCGAC
scaffold_95	reverse	CGTGGACCTGAGGGTTGAGCTTAGGGTTAGGTTAGTTAAGGGTTAGGTTAGGGTTAGGTTAGGGTTAGGGTTAGGGTTAGGGTTAGGGTTAGGGTTAGGG
scaffold_128	reverse	GGCCCGCGAGCCAAGTGCACTGTTTCATCGCATGCGAGGTTAGGGTTAGGGTTAGGGTTAGGGTTAGGGTTAGGGTTAGGGTTAGGGTTAGGGTTAGGGT

Telomeres found: 31 (14 forward, 17 reverse)
