scaffold_3	reverse	GACGTGACCAGCGCCCTCTAGTGTAAATCTTGCGTTGGCGCTATGGTTAGGGTTATGGTTAGGGTTAGGGTTAGGGTTAGGGTTAGGGTTAGGGTTAGGG
scaffold_6	forward	CCCTAACCCTAACCCTAACCCTAACCCTAACCCTAACCCTAACCCTAACCTAACCCTAAGGTCGTCAAGCGTACACTCGAGCCCTCGTACAGACTCGCGA
scaffold_7	forward	CCCTAACCCTAACCCTAACCCTAACCCTAACCCTAACCCTAACCCTAACCCTAACCTAACCCTAACCCTAACCCTGGGTCCGGATCCGGATACGCATTGG
scaffold_11	reverse	GTTCAACGGAGCTCGAATTTGTGTTATGTTAGGGTTAGGGTTAGGGTTATGGTTAGGGTTAGGGTTAGGGTTAGGGTTAGGGTTAGGGTTAGGGTTAGGG
scaffold_13	reverse	GCCCTCCCTACGACTCGGTTAGGTTAGGTTAGGGTTAGGGTTAGGGTTAGGGTTAGGGTTAGGGTTAGGGTTAGGGTTAGGGTTAGGGTTAGGGTTAGGG
scaffold_16	forward	CCCTAACCCTAACCCTAACCCTAACCCTAACCCTAACCCTAACCCTAACCCTAACCTAACCTAACCCTAACCCTAAAACGACTGACGCCCGGCACGACCT
scaffold_18	forward	CCCTAACCCTAACCCTAACCCTAACCCTAACCCTAACCCTAACCCTAACCCTAACCCTAACCCTAACCCTCCGAGCCCGTCACTATCGGCACTCGAACCG
scaffold_20	reverse	GCCCGCTCATTTTTTAGGGTTAGGTTAGGGTTAGGTTAGGTTAGGGTTAGGGTTAGGGTTAGGGTTAGGGTTAGGGTTAGGGTTAGGGTTAGGGTTAGGG
scaffold_22	reverse	AAAGGGGTCAGACTTGATCAGAGAGCGAGAAGGGTTAGGTTAGGGTTAGGGTTAGGGTTAGGGTTAGGGTTAGGGTTAGGGTTAGGGTTAGGGTTAGGGT
scaffold_23	reverse	TGACTCGATCCTGCGGTTAGGGTTAGGGTTAGGGTTAGGGTTAGGGTTAGGGTTAGGGTTAGGGTTAGGGTTAGGGTTAGGGTTAGGGTTAGGGTTAGGG
scaffold_32	forward	ACCCTAACCCTAACCCTAACCCTAACCCTAACCCTAACCTAACCAACCTAACCCTAACCCTAACCCTAACCTAACCTACTTGCTGGGAAACAGCGTGCTC
scaffold_38	forward	CCCTAACCCTAACCCTAACCCTAACCCTAACCCTAACCTAACCCTAACCCTAACCCTAACCCTAAGTTGCGCCCAGGTCCCTGCATAGTCATAGATGCCT
scaffold_40	reverse	CTCGCTATGCTTGGAATGCACTCAAAACTTAGGGTTAGGGTTAGGGTTAGGGTTAGGGTTAGGGTTAGGGTTAGGGTTAGGGTTAGGGTTAGGGTTAGGG
scaffold_41	forward	CCCTAACCCTAACCCTAACCCTAACCCTAACCCTAACCCTAACCCTAACCCTAATCTAACCCTTACCCTAACCCTAACCTAACCTAACCTTCCGAAGCAG
scaffold_43	reverse	AGTTGCAGGAACACCCACTTAGGGTTAGGTTAGGTTAGGGTTAGGTTAGGGTTAGGGTTAGGGTTAGGGTTAGGGTTAGGGTTAGGGTTAGGGTTAGGGT
scaffold_45	forward	CCCTAACCCTAACCCTAACCCTAACCCTAACCCTAACCCTAACCTAACCCTAACCCTAACCCTAAGCTGTGGGACGAGCAAGTGAAACGAGGCGAGATAG
scaffold_48	forward	CCCTAACCCTAACCCTAACCCTAACCCTAACCCTAACCATAACCCTAACCTAACCCTAACCTAACCCTAACCATCTGAGTGTAGCCACGAGCACTATAGA
scaffold_49	reverse	AACAAGGCGTGCGCTCCTCTCCTGTTTGGGTTATCCAGACTGACTCTTAGGGTTAGGGTTAGGGTTAGGGTTAGGGTTAGGGTTAGGGTTAGGGTTAGGG
scaffold_55	reverse	ACGCTCATTGTGCAGCTCAGAGCTTAGGGTTAGGTTAGGGTTAGGTTAGGGTTAGGGTTAGGGTTAGGGTTAGGGTTAGGGTTAGGGTTAGGGTTAGGGT
scaffold_58	reverse	GGGCCACAGTCTGGACCCTCGTTGGTTAGGTTAGGTTAGGGTTAGGGTTAGGGTTAGGGTTAGGGTTAGGGTTAGGGTTAGGTTAGGGTTAGGGTTAGGG
scaffold_62	reverse	CTGTTAGCGCGGGAACAGTTGTCAGTGTCGAAGGGTTAGGGTTAGGGTTAGGTTAGGGTTAGGGTTAGGGTTAGGGTTAGGGTTAGGGTTAGGGTTAGGG
scaffold_76	reverse	TACTGCTGCCAGCTTTCACTCTGAGGCGCTTAGGGTTAGGGTTAGGGTTAGGGTTAGGTTAGGGTTAGGGTTAGGGTTAGGGTTAGGGTTAGGGTTAGGG
scaffold_77	forward	CCCTAACCCTAACCCTAACCCTAACCCTAACCCTAACCCTAACCCTAACCCTAACCTAACCTAACCTAGCATCTCTGGCTGAGGAGACCCGTCGAGTCAA
scaffold_81	reverse	GGACGACGGATCCGAGCTTTCGATAAGGGTTAGGGTTAGGGTTAGGTTAGGGTTAGGGTTAGGGTTAGGGTTAGGGTTAGGGTTAGGGTTAGGGTTAGGG
scaffold_83	forward	CCCTAACCCTAACCCTAACCCTAACCCTAACCTAACCCTAACCTAACCTAACCCTAACCTAACCTAACCTAACCCCCCCCAGCAGAATCCCCAAGCAGGT
scaffold_85	forward	CCCTAACCCTAACCCTAACCCTAACCCTAACCCTAACCCTAACCCTAAGTAACCCTAACCGCATTGCCTTGACTGTCCTGCACCTCTCCGACTCGAGGCA
scaffold_89	forward	CCCTAACCCTAACCCTAACCCTAACCCTAACCCTAACCCTAACCCTAACCCTAACCCTAACCGAGTACTGTACACCGACGTTGAGACGAGAGTTTTGCGC
scaffold_91	forward	GTCCCTAACCCTAACCCTAACCCTAACCCTAACCCTAACCCTAACCCTAACCCTAACCTAACCCTAACCCTAACCCTCGAGCATTTTGGTCGACGAGCTT
scaffold_97	forward	CCCTAACCCTAACCCTAACCCTAACCCTAACCCTAACCTAACCCTAACCCTAACCCTAACCCTAACCTAACCCTAACCCTAACCTAACCCGAGTTGGTCG
scaffold_102	reverse	TAGGGTTAGGTTTAGGGTTAGGTTTAGGGTTAGGTTAGGGTTAGGGTTAGGGTTAGGGTTAGGGTTAGGGTTAGGGTTAGGGTTAGGGTTAGGGTTAGGG
scaffold_105	forward	CCCTAACCCTAACCCTAACCCTAACCCTAACCTAACCTAACCCTAACCTAACCCTAACCTAACAGGCGTACAAACGCTTCTATTCGCACATTGACACCAG

Telomeres found: 31 (16 forward, 15 reverse)
