scaffold_3	forward	CCCTAACCCTAACCCTAACCCTAACCCTAACCCTAACCCTAACCCTGACCCTAACCCTAACCTAACCCTAAGGTCGTCAAGCGTACACTCGAGCCCTCGT
scaffold_5	reverse	CAGCTCTTTTGCGAGGGGATAGGTTAGGTTTAGGGTTAGGTTAGGGTTAGGGTTAGGGTTAGGGTTAGGGTTAGGGTTAGGGTTAGGGTTAGGGTTAGGG
scaffold_8	forward	CCCTAACCCTAACCCTAACCCTAACCCTAACCCTAACCCTAACCCTAACCCTAACCCTAACCCTTTACCCCTAATCCATAACTTGACCCTAAGCCTAACC
scaffold_11	forward	CCCTAACCCTAACCCTAACCCTAACCCTAACCCTAACCCTAACCCTAACCTAACCCTAACTCTAACCTAACCCTAACCTAACCCTAACCCTAAGCACACA
scaffold_12	reverse	CCCGCTCATTTTTTAGGGTTAGGTTAGGGTTAGTCAGGGTTAGGGTTAGGGTTAGGGTTAGGGTTAGGGTTAGGGTTAGGGTTAGGGTTAGGGTTAGGGT
scaffold_13	forward	CCCTAACCCTAACCCTAACCCTAACCCTAACCCTAACCCTAACCCTAACCCTAGCCCTAACCCTACCCTAACCCTAACCCTAACCCTAACCCTAACCCTA
scaffold_19	forward	CCCTAACCCTAACCCTAACCCTAACCCTAACCCTAACCCTAACCCTAACCCTAACCCTAACCCTAACCCTAACCCTAACCTAACCCTTCTCGCTCTCTGA
scaffold_20	reverse	CTCTCTTTGTCAAAGCCCCGCTCGACTTAGGGTTAGGGTTTAGGGTTAGGGTTAGGGTTAGGGTTAGGGTTAGGGTTAGGGTTAGGGTTAGGGTTAGGGT
scaffold_21	reverse	CCTACGACTCGGTTAGGTTAGGTTAGGGTTAGGGTTAGGGTTAGGGTTAGGGTTAGGGTTAGGGTTAGGGTTAGGGTTAGGGTTAGGGTTAGGGTTAGGG
scaffold_22	forward	CCCTAACCCTAACCCTAACCCTAACCATAACCCTAACCTAACCTAACCTAACCCCCCCCCCAGCAGAATCCCCAAGCAGGTGCGAGGAAAAAGTGCGACT
scaffold_26	forward	CCCTAACCCTAACCCTAACCCTAACCCTAACCCTAACCCTAACCCTAACCCTAACCCTAACCCTAACCCTAACCCTAACCTAACCCTAACCACCTCGGTG
scaffold_32	forward	CCCTAACCCTAACCCTAACCCTAACCCTAACCCTAACCCTAACCCTAACCCTGACCCTAACCCTAACCATAACCCTAACCCTAACCTATCCTAACCCTAA
scaffold_40	reverse	CGGAAGGTTAGGTTAGGTTAGGGTTAGGGTAAGGGTTAGATTAGGGTTAGGGTTAGGGTTAGGGTTAGGGTTAGGGTTAGGGTTAGGGTTAGGGTTAGGG
scaffold_43	reverse	CCTTACTCTATTCTGCACAACCCGGTGGTTAGGGTTAGGGTTAGGGTTAGGGTTAGGGTTAGGGTTAGGGTTAGGGTTAGGGTTAGGGTTAGGGTTAGGG
scaffold_48	forward	CCCTAACCCTAACCCTAACCCTAACCCTAACCCTAACCCTAACCCTAACCCTAACTATAACCCTAACCTAACCCTAACCTAACCCTAACCATCTGAGTGT
scaffold_49	forward	AACCCTAACCCTAACCCTAACCCTAACCCTAACCCTAACCCTAACCCTAACCTAACCCTAACCCTAACCCTAAGAGTCAGTCTGGATAACCCAAACAGGA
scaffold_51	forward	CCCTAACCCTAACCCTAACCCTAACCCTAACCCTAACCCTAACCCTAACCTAACCCTAACCCTAACCCACTCTGGGGCAACTTTCTTGCGGCCACCCGCC
scaffold_58	forward	CCCTAACCCTAACCCTAACCCTAACCCTAACCCTAACCCTAACCCTAACCCTAACCTAACCCTAACCTAACCCTAAGCTCTGAGCTGCACAATGAGCGTA
scaffold_60	forward	CCCTAACCCTAACCCTAACCCTAACCCTAACCCTAACCCTAACCCTAACCTAACCTAACCAACGAGGGTCCAGACTGTGGCCCTAGCAGAATCGGATAGA
scaffold_64	reverse	CCGAGCCGGTTCGGAGTTCTAACTCGCCTTAGGGTTAGGGTTAGGGTTAGGGTTAGGGTTAGGGTTAGGGTTAGGGTTAGGGTTAGGGTTAGGGTTAGGG
scaffold_66	reverse	TTGTCCGTTCAACGGAGCTCGAATTTGTGTTATGTTAGGGTTAGGGTTAGGGTTAGGGTTAGGGTTAGGGTTAGGGTTAGGGTTAGGGTTAGGGTTAGGG
scaffold_73	forward	CCCTAACCCTAACCCTAACCCTAACCCTAACCCTAACCCTAACCCTAACCCTAACCCTAACCCTAACCCTAACCCTAACCCTAACCCTTATCGAAAGCTC
scaffold_86	reverse	GGGTTGTCGCGTTCTTCCGCAAGCACTGCGTTCGTTAGGGTTAGGGTTAGGGTTAGGGTTAGGGTTAGGGTTAGGGTTAGGGTTAGGGTTAGGGTTAGGG
scaffold_89	reverse	GCACCTTTGACTCGACGGGTCTCCTCAGCCAGAGATGCTAGGTTAGGTTAGGTTAGGGTTAGGGTTAGGGTTAGGGTTAGGGTTAGGGTTAGGGTTAGGG
scaffold_99	forward	CCCTAACCCTAACCCTAACCCTAACCCTAACCCTAACCCTAACCCTAACCCTAACCCTAACCCTAACCCTAACCCTAACCCTAACCTAACCTAACCCGAG
scaffold_105	forward	CCCTAACCCTAACCCTAACCCTAACCCTAACCCTAACCCTAACCCTAACCCTAACACTAACCCTAACCCTAACCTAACTTGATGTGGAAACGTACCGCAC
scaffold_109	reverse	ATGACTATGCAGGGACCTGGGCGCAACTTAGGGTTAGGGTTAGGGTTAGGGTTAGGGTTAGGGTTAGGGTTAGGGTTAGGGTTAGGGTTAGGGTTAGGGT
scaffold_115	forward	CCCTAACCCTAACCCTAACCCTAACCCTAACCCTAACCCTAACCCTAACCCTAACCCTAACCCTAACCCTAACCCTAACCCTAACCTAACCCTAACCCTA
scaffold_120	forward	CCCTAACCCTAACCCTAACCCTAACCCTAACCCTAACCCTAACCCTAACCTAACCCTTCGACACTGACAACTGTTCCCGCGCTAACAGGACAAGGTCTAC
scaffold_121	forward	CCCTAACCCTAACCCTAACCCTAACCCTAACCCTAACCCTAACCCTAACCCTAACCCTAACCCTAACCCTAACCCTAACCCTAACCCTAACCTAAATGTC
scaffold_123	forward	CCCTAACCCTAACCCTAACCCTAACCCTAACCCTAACCCTAACCCTAACCCTAACCTAACCCTAACCTAACAGGCGTACAAACGCTTCTATTCGCACATT

Telomeres found: 31 (20 forward, 11 reverse)
