scaffold_1	forward	CCCTAACCCTAACCCTAACCCTAACCCTAACCCTAACCCTAACCCTAACCTAACCCTAACCCTAACGGCCCTAACAGCTCTAACCGACTCTAACAGGCCA
scaffold_3	forward	CCCTAACCCTAACCCTAACCCTAACCCTAACCCTAACCCTAACCCTAACCCTAACCCTAACCCTAACCCTAACCCTTGCGCCAACCGGTCCCACATCCTC
scaffold_6	forward	CCCTAACCCTAACCCTAACCCTAACCCTAACCCTAACCCTAACCCTAACCCTAACCCTAACCCTACATGCCCAAGCTGCATGTTCTGAACTGGCCTACAC
scaffold_7	reverse	TGCGCGGGTTGACTCGATCCTGCGGTTAGGGTTAGGGTTAGGGTTAGGGTTAGGGTTAGGGTTAGGGTTAGGGTTAGGGTTAGGGTTAGGGTTAGGGTTA
scaffold_8	reverse	TCTTAGGGTTAGGCTTAGGGTCAGGTTATGGATTAAGGGTAAAGGGTTAGGGTTAGGGTTAGGGTTAGGGTTAGGGTTAGGGTTAGGGTTAGGGTTAGGG
scaffold_10	reverse	CCGTCGCATCGGGGCAGCCTTAGGTTAGGGTTAGGGTTAGGGTTAGGTTAGGGTTAGGTTAGGGTTAGGGTTAGGGTTAGGGTTAGGGTTAGGGTTAGGG
scaffold_12	forward	ACCCTAACCCTAACCCTAACCCTAACCCTAACCCTAACCCTAACCCTAACCCTAACCCTTCTCGCTCTCTGATCAAGTCTGACCCCTTTCATAACCCTGC
scaffold_18	forward	CCCTAACCCTAACCCTAACCCTAACCCTAACCCTAACCCTAACCCTAACCCTAACCCTAACCCTAACCCTAACCTAACCCTAACCCTAACCGAATGGAGA
scaffold_19	forward	CCCTAACCCTAACCCTAACCCTAATCCTAACCCTAACCCTAACCCTGACCCTAACCCTAACCCTAACTAACCCTAACCTAACCCTAAAAAATGAGCGGGC
scaffold_20	forward	ACCCTAACCCTAACCCTAACCCTAACCCTAACCCTAACCCTAACCCTAACCCTAACCCTAACCTAACCCTAACCTAACCCCTAAGACTCCCGCGGCTCGA
scaffold_23	reverse	GAGGAAGTGCACATGGAGCTGAAACTTGAGCAAAGTGCTTCCCACCAAGGTTAGGGTTAGGGTTAGGGTTAGGGTTAGGGTTAGGGTTAGGGTTAGGGTT
scaffold_33	reverse	AGCACGCTGTTTCCCAGCAAGTAGGTTAGGTTAGGGTTAGGATAGGTTAAGGTTAGGGTTAGGGTTAGGGTTAGGGTTAGGGTTAGGGTTAGGGTTAGGG
scaffold_36	forward	CCCTAACCCTAACCCTAACCCTAACCCTAACCCTAACCCTAACCCTAACCCTAACCCTAACCCTAATCCTAACCCTAACCCTTCGACACTGACAACTGTT
scaffold_39	reverse	TGACTATGCAGGGACCTGGGCGCAACCGAGAGGTTAGGGTTAGGGTTAGGGTTAGGGTTAGGGTTAGGGTTAGGGTTAGGGTTAGGGTTAGGGTTAGGGT
scaffold_43	forward	CCCTAACCCTAACCCTAACCCTAACCCTAACCCTAACCCTAACCCTAACCTAACCCTAACCTAACCCTAAACCTAACCTATCCCCTCGCAAAAGAGCTGA
scaffold_45	forward	ACCCTAACCCTAACCCTAACCCTAACCCTAACCCTAACCCTAACCCTAACCCTAACCTAACCGAGTCGTAGGGAGGGCAAGTTGGGCGTGCGAAGTTGGG
scaffold_48	reverse	TGCTCGTGGCTACACTCAGATGGTTAGGGTTAGGTTAGGGTTAGGGTTAGGGTTAGGGTTAGGGTTAGGGTTAGGGTTAGGGTTAGGGTTAGGGTTAGGG
scaffold_49	reverse	GGGTGGTCTCCTTCTTGAAGGCGCGCTCTTAGGGTTAGGGTTAGGGTTAGGGTTAGGGTTAGGGTTAGGGTTAGGGTTAGGGTTAGGGTTAGGGTTAGGG
scaffold_55	forward	CCCTAACCCTAACCCTAACCCTAACCCTAACCCTAACCCTAACCCTAACCCTAAACATAACCCTAACCCTAACCCTAACCTAACCCTAACCTAACCCTAA
scaffold_56	forward	CCCTAACCCTAACCCTAACCCTAACCCTAACCCTAACCCTAACCCTAACCTAACCTAACCAACGAGGGTCCAGACTGTGGCCCTAGCAGAATCGGATAGA
scaffold_63	reverse	GGTTAGGTTAGGTTAGGGTTACTTAGGGTTAGGATTAGGGGTAAGGTTAGGGTTAGGGTTAGGGTTAGGGTTAGGGTTAGGGTTAGGGTTAGGGTTAGGG
scaffold_65	forward	AACCCTAACCCTAACCCTAACCCTAACCCTAACCCTAACCCTAACCCTAACCCTAACCCTAACCGAGTACTGTACACCGACGTTGAGACGAGAGTTTTGC
scaffold_69	reverse	GTCGCGTTCTTCCGCAAGCACTGCGTTTGTTAGGGTTAGGTTAGGGTTAGGGTTAGGGTTAGGGTTAGGGTTAGGGTTAGGGTTAGGGTTAGGGTTAGGG
scaffold_71	forward	CCCTAACCCTAACCCTAACCCTAACCCTAACCCTAACCCTAACCCTAACCCTAACCCTATCCCTAACCCTAACCCTAACCCTAACCTAACCTAACCTAGC
scaffold_77	forward	CCCTAACCCTAACCCTAACCCTAACCCTAACCCTAACCCTAACCCTAACCCTAATCCTAACCATAACCCTAACCATAGCGCCAACGCAAGATTTACACTA
scaffold_78	forward	CCCTAACCCTAACCCTAACCCTAACCCTAACCCTAACCCTAACCTAACACTAACCCTAACCCTAACCCATAGCCGCTTGCCCAGCGTATCCGGGTGTGTG
scaffold_80	reverse	GCTCTCGCTATGCTTGGAATGCACTCAAAACTTAGGGTTAGGGTTAGGTTAGGGTTAGGTTAGGGTTAGGGTTAGGTTAGGGTTAGGGTTAGGGTTAGGG
scaffold_84	forward	CCCTAACCCTAACCCTAACCCTAACCCTAACCCTAACCCTAACCCTAACACTAACCCTAACCTAACCCTAACCCTAACCTAACCCTAACCCTAACCCTCG
scaffold_90	forward	CCCTAACCCTAACCCTAACCCTAACCCTAACCCTAACCCTAACCCTAACCCTAACCATAACCCTAACCCTAACCCTAACATAACACAAATTCGAGCTCCG
scaffold_91	forward	CCCTAACCCTAACCCTAACCCTAACCCTAACCCTAACCCTAACCCTAACCCTAACCCTAATCCTAACCCTAACCCTAACCCTAACCCTAACCCTAACCCT
scaffold_93	reverse	TGTACGCCTGTTAGGTTAGGGTTAGGTTAGGTTTAGGGTTAGGGTTAGGGTTAGGGTTAGGGTTAGGGTTAGGGTTAGGGTTAGGGTTAGGGTTAGGGTT
scaffold_139	reverse	CCACACCTGCCCGCTGCCCTCGCCGCCCCCGCGCTCAGGGTTAGGGTTAGGGTTAGGGTTAGGGTTAGGGTTAGGGTTAGGGTTAGGGTTAGGGTTAGGG

Telomeres found: 32 (19 forward, 13 reverse)
