scaffold_1	reverse	AGGGTTAGGGTTAGGGTTAGGGTTAGGGTTAGGGTTAGGGTTAGGGTTAGGGTTAGGGTTAGGGTTAGGGTTAGGGTTAGGGTTAGGGTTAGGGTTAGGG
scaffold_2	reverse	CGGGTCGCTCGCGCCACAATGGCTGTTCTTAGGGTTAGGGTTAGGGTTAGGGTTAGGGTTAGGGTTAGGGTTAGGGTTAGGGTTAGGGTTAGGGTTAGGG
scaffold_10	reverse	ATTATATAGCCAAAGGTGCGCGCGAACTTAGGGTTAGGGTTAGGTTAGGGTTAGGGTTAGGGTTAGGGTTAGGGTTAGGGTTAGGGTTAGGGTTAGGGTT
scaffold_12	reverse	AGGGTTAAGGGTTAGGGTTAGGGTTAGGGTTAGGGTTAGGGTTAGGGTTAGGGGGGCAAGGAAACGTCAGCTTCGCCGCTGGTGCATTGCCTTGCAGGAC
scaffold_17	forward	CCCTAACCCTAACCCTAACCCTAACCCTAACCCTAACCCTAACCCTAACCTAACCCTAACCCTAACCCTAACCCGGGTCCGCAACTTTGTTCACGGTCTC
scaffold_28	forward	CCCTAACCCTAACCCTAACCCTAACCCTAACCCTAACCCTAACCCTAACCCTAACCCTAACCCTAACCCTAACCCTAGCCTTCACCCTGACCCTGACCCA
scaffold_29	forward	CCCTAACCCTAACCCTAACCCTAACCCTAACCCTAACCCTAACCCTAACCCTAACCCTGACCCTAACCCTAACCCTAAGGTGCCCGAGCGATGAGGGGAG
scaffold_31	reverse	CAAGGTCAGAACTGGGGCCACCCCAGGTTAGGGTTAGGGTTAGGGTTAGGGTTAGGGTTAGGGTTAGGGTTAGGGTTAGGGTTAGGGTTAGGGTTAGGGT
scaffold_36	reverse	AGGGTCAGGGTCAGGGTCAGGGTCAGGGTCAGGGTTAGGGTTAGGGTTAGGGTTAGGGTTAGGGTTAGGGTTAGGGTTAGGGTTAGGGTTAGGGTTAGGG
scaffold_38	reverse	AACCTAGGGTTAGGGTTAGGGTTAGGGTTAGGTTAGATTAGGTTAGGTTAGGGTTAGGGTGAGGTTAGGGTTAGGGTTAGGGTTAGGGTTAGGGTTAGGG
scaffold_46	reverse	CAGGGTTAGAGTTAGGTCAGGATTAAGGTTAGGGTTAGGGTTAGGGTTAGGGTTAGGGTTAGGGTTAGGGTTAGGGTTAGGGTTAGGGTTAGGGTTAGGG
scaffold_49	reverse	CAGCGCAGTTGCACAATCGTGTCGCGACTTAGGGTTAGGGTTAGGGTTAGGGTTAGGGTTAGGGTTAGGGTTAGGGTTAGGGTTAGGGTTAGGGTTAGGG
scaffold_53	reverse	GCGCCGCTGCTGCTCCCATTCGGTTCGCGCCTGCTTAGGGTTAGGGTTAGGGTTAGGGTTAGGGTTAGGGTTAGGGTTAGGGTTAGGGTTAGGGTTAGGG
scaffold_62	forward	AACCCTAACCCTAACCCTAACCCTAACCCTAACCCTAACCCTAACCCTAACCCTAACCCTAACCCTAACCCTAACCCAACCCTAACCCTAAGGCAAGCAA
scaffold_66	forward	CCCTAACCCTAACCCTAACCCTAACCCTAACCCTAACCCTAACCCTAACCTTAACCCTAACCTTAATCTTAGCCCTACCCTAGTCTTATCCCTAACCCTA
scaffold_67	forward	CCCTAACCCTAACCTAACCCTAACCCTAACCCTAACCCTAACCCTAACCTAACCCTAACCCTAACCCTAACCCTGACCCTGACCCTGACCCTGACCCTAA
scaffold_68	forward	CCCTAACCCTAACCCTAACCCTAACCCTAACCCTAACCCTAACCCTAACCCTAACCCTAACCTAACCCTAACCTCGCGTCAACTGCGGTCCTTCGGCGCG
scaffold_69	forward	CCCTAACCCTACCCCTAACCCTAACCCTAACCCTAACCCTAACCCTACCCCTAACCCTAACCCTAACCCTAAGTAACCCTAAGCCTAACCTGAGCACATG
scaffold_75	reverse	GGTTAGGGTTAGGGTTAGGATTAGGATTAGGGTTAGGGTTAGGATTAGGATTAGGATTAGGGTTAGGGTTAGGGTTAGGGTTAGGGTTAGGGTTAGGGTT
scaffold_82	reverse	GTTGGGACGGTTCTGCCTTAGGGTTAGGGGTTAGGTTAGGTTAGGTTAGGGTTAGGGTTAGGGTTAGGGTTAGGGTTAGGGTTAGGGTTAGGGTTAGGGT
scaffold_84	reverse	TAGGGTCAGAGTAAGACTAAGTTCAGGGTTAGGGTTAGGGTTAGGGTTAGGGTTAGGGTTAGGGTTAGGGTTAGGGTTAGGGTTAGGGTTAGGGTTAGGG
scaffold_97	reverse	ACACTTTGATTTAGGGTTAGGGTTAGGGTTAGGGTTAGGGTTAGGGTTAGGGTTAGGGTTAGGGTTAGGGTTAGGGTTAGGGTTAGGGTTAGGGTTAGGG
scaffold_104	reverse	AGCGGTCACAATGCATAGTCTGACAGGGTTAGGGTTAGGGTTAGGGTTAGGGTTAGGGTTAGGGTTAGGGTTAGGGTTAGGGTTAGGGTTAGGGTTAGGG
scaffold_110	reverse	AGGGTTAGGGTCAGGACTAGGGTTAGGACCACGGTTAGGGTTAGGGTTATGGTTAGGGTTAGGGTTAGGGTTAGGGTTAGGGTTAGGGTTAGGGTTAGGG
scaffold_111	forward	CCCTAACCCTAACCCTAACCCTAACCCTAACCCTAACCCTAACCCTAACCCTAACCCTAACCCTAAGACAGGAAGTCGCCACATCATCGACTCGCCCACA
scaffold_118	reverse	GGGTTAGGGTCAGGGTTAGGGCTAGGGTTAGGGCTAGGGTTAGGGTTAGGGATTAGGGTTAGGGTTAGGGTTAGGGTTAGGGTTAGGGTTAGGGTTAGGG
scaffold_121	reverse	TGCGCAGCTCTTGGGGTTAGGGTTAGGTTAGGGTTAAGGTCAGAGCTTAGGGTTAGGGTTAGGGTTAGGGTTAGGGTTAGGGTTAGGGTTAGGGTTAGGG
scaffold_131	reverse	GTGCACGTCGAGTCGAACGCAACTTAGGGTTAGGTTAGGGTTAGGGTTAGGGTTAGGGTTAGGGTTAGGGTTAGGGTTAGGGTTAGGGTTAGGGTTAGGG
scaffold_133	reverse	TAGGTTAGGATTAGGGGTAGGATTAGAGTTAGAGTTAGGGTTAGAGTTAGGGTTAGGGTTAGGGTTAGGGTTAGGGTTAGGGTTAGGGTTAGGGTTAGGG
scaffold_158	forward	CCCTAACCCTAACCCTAACCCTAACCCTAACCCTAACCCTAACCCTAACCCTAACCCTAACCCTAACCCTAACCCTAACCCTAACCCTAACCTAACCCTA
scaffold_163	reverse	CACTTAGGGGTAGGGTTAGGGTTAGGGTTAGGGTTAGGGTTAGAGTTAGGGTTAGGGTTAGGGTTAGGGTTAGGGTTAGGGTTAGGGTTAGGGTTAGGGT

Telomeres found: 31 (10 forward, 21 reverse)
