scaffold_3	reverse	TTTTGCCGAGGGTTAGGTTAGGTTAGGGTTAGGTTAGGTTAGGGTTAGGGTTAGGGTTAGGGTTAGGGTTAGGGTTAGGGTTAGGGTTAGGGTTAGGGTT
scaffold_5	reverse	TAAATCTTGCGTTGGCGCTATGGTTAGGGTTAGGGTTAGGTTAGGGTTAGGGTTAGGGTTAGGGTTAGGGTTAGGGTTAGGGTTAGGGTTAGGGTTAGGG
scaffold_7	forward	AACCCTAACCCTAACCCTAACCCTAACCCTAACCCTAACCCTAACCCTAACCCTAACCCTAACCCTAACCCTAAACCAGCACATCTTACAAAGCAAGGCT
scaffold_9	forward	CCCTAACCCTAACCCTAACCCTAACCCTAACCCTAACCCTAACCCTAACCCTAACCCTAACCCTAACCCTAACCGAACTGGTGCGGTTGGTCCATCTCGC
scaffold_10	reverse	GCGCTTTTTCCTCGCACCTGCTTCGGAAGGTTAGGTTAGGTTAGGGTTAGGGTTAGGGTTAGGGTTAGGGTTAGGGTTAGGGTTAGGGTTAGGGTTAGGG
scaffold_15	reverse	TTAGGGTTAGGGTTAGGTTAGGGTTAGGTTAGGGTTAGGGTTAGGGTTAGGCTTTAGGTTAGGGTTAGGGTTAGGGTTAGGGTTAGGGTTAGGGTTAGGG
scaffold_17	reverse	CCCATCGCCCGCTCATTTTTTAGGGTTAGGTTAGGGCTAGTTAGGGTTAGGGTTAGGGTTAGGGTTAGGGTTAGGGTTAGGGTTAGGGTTAGGGTTAGGG
scaffold_19	reverse	CTCCATTCGGTTAGGGTTAGGGTTAGGGTTAGGGTTAGGGTTAGGGTTAGGGTTAGGGTTAGGGTTAGGGTTAGGGTTAGGGTTAGGGTTAGGGTTAGGG
scaffold_21	reverse	GAGTCTTAGTGTTAGGTTAGGGTTAGGCTTAGGGTTAGGGTTAGGGTTAGGGTTAGGGTTAGGGTTAGGGTTAGGGTTAGGGTTAGGGTTAGGGTTAGGG
scaffold_25	forward	CCCTAACCCTAACCCTAACCCTAACCCTAACCCTAACCCTAACCCTAACCCTAACCCTAACCCTAACCCTAACCGCAGGATCGAGTCAACCCGCGCACGT
scaffold_27	forward	CCCTAACCCTAACCCTAACCCTAACCCTAACCCTAACCCTAACCCTAACCCTAACCCTAACCCTAACCTAACCTAACCCTCAGCCTCACGCAGTATTCCT
scaffold_33	reverse	TTTGTCTTTTCGCCCTCTTCGAACAAGGTTTAGGGTTAGGTTAGGGTTAGGTTAGGGGTTAGGGTTAGGGTTAGGGTTAGGGTTAGGGTTAGGGTTAGGG
scaffold_35	forward	ACCCTAACCCTAACCCTAACCTTAACCCTAACCCTAACCCTAACCCTAACCCTAACCTAACCTAACCCTAACCTTAAGCGAGGAATGGAGTCGGCAGCTG
scaffold_37	reverse	GGCATCTATGACTATGCAGGGTTAGGGTTAGGGGTTAGGTTTAGGGTTAGGGTTAGGGTTAGGGTTAGGGTTAGGGTTAGGGTTAGGGTTAGGGTTAGGG
scaffold_40	forward	CCCTAACCCTAACCCTAACCCTAACCCTAACCCTAACCCTAACCCTAACCCTAACCCTAACCCTAACCCTAACCTAAAATGAGCCCTAGCTTGAAAGGCT
scaffold_41	forward	CCCTAACCCTAACCCTAACCCTAACCCTAACCCTAACCCTAACCCTAACCCTAACCTAACCCTAACCTAACCCTAACCCTAAGATCTATAGCTAACAGTC
scaffold_45	reverse	GCTGTTTTCGATTTAGGGTTAGGTTAGGGTTAGGTTAGGGTTAGGGTTAGGGTTAGGGTTAGGGTTAGGGTTAGGGTTAGGGTTAGGGTTAGGGTTAGGG
scaffold_47	reverse	AACCCGTACTTTTTAGTGGAAACTTATGGTTAGGGTTAGGTTAGGGTTAGGGTTAGGGTTAGGGTTAGGGTTAGGGTTAGGGTTAGGGTTAGGGTTAGGG
scaffold_50	forward	CCCTAACCCTAACCCTAACCCTAACCCTAACCCTAACCCTAACCCTAATCCTAACCTAACCCTAACCTAACCCTAACCTAACCCTAACCTAACCCTATGC
scaffold_53	reverse	AGTTAGGATTAGGGTTAGGTTAGGGTTAGGTTAGGTTAGGGTTAGGTTAGGGTTAGGGTTAGGGTTAGGGTTAGGGTTAGGGTTAGGGTTAGGGTTAGGG
scaffold_57	reverse	CAGGGTTAGGGCCAGGGTTAGGGTTAGGGTTAGGTTAGGGTTAGGGTTAGGGTTAGGGTTAGGGTTAGGGTTAGGGTTAGGGTTAGGGTTAGGGTTAGGG
scaffold_62	reverse	AGGCAATTTTGAGGCTGATGTGCTTAGGGTTAGGGTTAGGGTTAGGTTAGGGTTAGGTTAGGGTTAGGGTTAGGGTTAGGGTTAGGGTTAGGGTTAGGGT
scaffold_65	reverse	CTCGCGAGTGATCGCGGAAAGCGGTTAGGTTAGGGTTAGGTTAGGGTTAGGGTTAGGGTTAGGGTTAGGGTTAGGGTTAGGGTTAGGGTTAGGGTTAGGG
scaffold_66	reverse	ACACCTTCAGGACGGCATTTTCGGTTAGGGTTAGGTTAGGGTTAGGTTAGGGTTAGGGTTAGGGTTAGGGTTAGGGTTAGGGTTAGGGTTAGGGTTAGGG
scaffold_74	forward	CCCTAACCCTAACCCTAACCCTAACCCTAACCCTAACCCTAACCCTAACCCTAACCCTAACCCTAACCCTAACCTAACCCTAACCCTAACCTAACCCTAA
scaffold_77	reverse	GTCAAGGCAATGCGGTTAGGGTTAGGGGTTAGGGTTAGGGTTAGGGTTAGGGTTAGGGTTAGGGTTAGGGTTAGGGTTAGGGTTAGGGTTAGGGTTAGGG
scaffold_84	forward	CCCTAACCCTAACCCTAACCCTAACCCTAACCCTAACCCTAACCCTAACCCTAACCTAACCTAACCCTAACCAACGAGGGTCCAGACTGTGGCCCTAGCA
scaffold_87	reverse	TAGGGTTAGGGTTAGGTTAGGGTTAGGGTTAGGGTTAGGGTTAGGGTTAGGGTTAGGGTTAGGGTTAGGGTTAGGGTTAGGGTTAGGGTTAGGGTTAGGG
scaffold_90	reverse	GGGTTAGGGTTAGGGTTAGGGTTAGGGTTAGGGTTAGGGTTAGGGTTAGGGTTAGGGTTAGGGTTAGGGTTAGGGTTAGGGTTAGGGTTAGGGTTAGGGT

Telomeres found: 29 (10 forward, 19 reverse)
