scaffold_3	forward	CCCTAACCCTAACCCTAACCCTAACCCTAACCCTAACCCTAACCCTAATCCTAACCATAACCCTAACCATAGCGCCAACGCAAGATTTACACTAGAGGGC
scaffold_5	forward	CCCTAACCCTAACCCTAACCCTAACCCTAACCCTAACCCTAACCCTAACCCTAACCCTAACCCTAACCCTAACCGCAGGATCGAGTCAACCCGCGCACGT
scaffold_6	reverse	GTCGCATCGGGGCAGCCTTAGGTTAGGGTTAGGGTTAGGGTTAGGGTTAGGGTTAGGGTTAGGGTTAGGGTTAGGGTTAGGGTTAGGGTTAGGGTTAGGG
scaffold_9	reverse	GTCAGACTTGATCAGAGAGCGAGAAGGGTTAGGGTTAGGGTTAGGGTTAGGGTTAGGGTTAGGGTTAGGGTTAGGGTTAGGGTTAGGGTTAGGGTTAGGG
scaffold_10	reverse	TCAGCTCTTTTGCGAGGGGATAGGTTAGGTTTAGGGTTAGGTTAGGGTTAGGTTAGGGTTAGGGTTAGGGTTAGGGTTAGGGTTAGGGTTAGGGTTAGGG
scaffold_11	forward	CCCTAACCCTAACCCTAACCCTAACCCTAACCCTAACCCTAACCCTAACCCTAACCCTAACCCTAACCCTTTACCCTTAATCCATAACCTGACCCTAAGC
scaffold_13	forward	CCCTAACCCTAACCCTAACCCTAACCCTAACCCTAACCCTAACCCTAACCCTAACCCTAACCTAACCCTAACCCTAACCGAATGGAGAGCAAGAGAAGGG
scaffold_15	forward	CCCTAACCCTAACCCTAACCCTAACCCTAACCCTAACCCTAACCCTAACCCTAACCCTAACCTAACCCTAACCTAACCCCTAAGACTCCCGCGGCTCGAA
scaffold_18	reverse	GCCCGCTCATTTTTTAGGGTTAGGTTAGGGTTAGTTAGGGTTAGGGTTAGGGTCAGGGTTAGGGTTAGGGTTAGGGTTAGGGTTAGGGTTAGGGTTAGGG
scaffold_23	reverse	AGCTGAAACTTGAGCAAAGTGCTTCCCACCAAGGTTAGGGTTAGGGTTAGGGTTAGGGTTAGGGTTAGGGTTAGGGTTAGGGTTAGGGTTAGGGTTAGGG
scaffold_27	reverse	TCAGAACATGCAGCTTGGGCATGTAGGGTTAGGGTTAGGGTTAGGGTTAGGGTTAGGGTTAGGGTTAGGGTTAGGGTTAGGGTTAGGGTTAGGGTTAGGG
scaffold_31	reverse	CATTGTGCAGCTCAGAGCTTAGGGTTAGGTTAGGGTTAGGTTAGGGTTAGGGTTAGGGTTATGTTTAGGGTTAGGGTTAGGGTTAGGGTTAGGGTTAGGG
scaffold_32	reverse	CTGCGTCGACGCTTGTCCGTTCAACGGAGCTCGAATTTGTGTTATGTTAGGGTTAGGGTTAGGGTTATGGTTAGGGTTAGGGTTAGGGTTAGGGTTAGGG
scaffold_37	reverse	CCAGCAAGTAGGTTAGGTTAGGGTTAGGATAGGTTAAGGTTAGGGTTAGGGTTAGGGTTAGGGTTAGGGTTAGGGTTAGGGTTAGGGTTAGGGTTAGGGT
scaffold_41	forward	CCCTAACCCTAACCCTAACCCTAACCCTAACCCTAACCCTAACCCTAACCCTAACCCTAACCTCTCGGTTGCGCCCAGGTCCCTGCATAGTCATAGATGC
scaffold_45	forward	CCCTAACCCTAACCCTAACCCTAACCCTAACCCTAACCCTAACCCTAACCCTAACCCTAACCCTAACCCTAACCTAACCTAACCGAGTCGTAGGGAGGGC
scaffold_47	forward	ACCCTAACCCTAACCCTAACCCTAACCCTAACCCTAACCCTAACCCTAACCCTAACCCTAACCTAACCCTAACCCTAACGGCCCTAACAGCTCTAACCGA
scaffold_50	reverse	TGCTCGTGGCTACACTCAGATGGTTAGGGTTAGGTTAGGGTTAGGGTTAGGGTTAGGGTTAGGGTTAGGGTTAGGGTTAGGGTTAGGGTTAGGGTTAGGG
scaffold_51	reverse	GCCGTCGCCGCCGGGTGGTCTCCTTCTTGAAGGCGCGCTCTTAGGGTTAGGGTTAGGGTTAGGGTTAGGGTTAGGGTTAGGGTTAGGGTTAGGGTTAGGG
scaffold_60	reverse	GTTAGGTTAGGTTAGGGTTACTTAGGGTTAGGATTAGGGGTAAGGTTAGGGTTAGGGTTAGGGTTAGGGTTAGGGTTAGGGTTAGGGTTAGGGTTAGGGT
scaffold_65	forward	CCCTAACCCTAACCCTAACCCTAACCCTAACCCTAACCCTAACCCTAACCCTAACCCTAACCCTAACCCTAACCGAGTACTGTACACCGACGTTGAGACG
scaffold_66	reverse	ACAGTTGTCAGTGTCGAAGGGTTAGGGTTAGGATTAGGGTTAGGGTTAGGGTTAGGGTTAGGGTTAGGGTTAGGGTTAGGGTTAGGGTTAGGGTTAGGGT
scaffold_67	reverse	GTCTCCTCAGCCAGAGATGCTAGGTTAGGTTAGGTTAGGGTTAGGGTTAGGGTTAGGGATAGGGTTAGGGTTAGGGTTAGGGTTAGGGTTAGGGTTAGGG
scaffold_75	reverse	GTCGCGTTCTTCCGCAAGCACTGCGTTTGTTAGGGTTAGGTTAGGGTTAGGGTTAGGGTTAGGGTTAGGGTTAGGGTTAGGGTTAGGGTTAGGGTTAGGG
scaffold_76	forward	CCCTAACCCTAACCCTAACCCTAACCCTAACCCTAACCCTAACCTAACCTAACCAACGAGGGTCCAGACTGTGGCCCTAGCAGAATCGGATAGAGCCTTT
scaffold_82	reverse	TTGCTCTCCTTACACACACCCGGATACGCTGGGCAAGCGGCTATGGGTTAGGGTTAGGGTTAGTGTTAGGTTAGGGTTAGGGTTAGGGTTAGGGTTAGGG
scaffold_84	reverse	CTTGGAATGCACTCAAAACTTAGGGTTAGGGTTAGGTTAGGGTTAGGTTAGGGTTAGGGTTAGGTTAGGGTTAGGGTTAGGGTTAGGGTTAGGGTTAGGG
scaffold_88	forward	CCCTAACCCTAACCCTAACCCTAACCCTAACCCTAACCCTAACCCTAACCCTAACCCTAACACTAACCCTAACCTAACCCTAACCCTAACCTAACCCTAA
scaffold_97	forward	CCCTAACCCTAACCCTAACCCTAACCCTAACCCTAACCCTAACCCTAACCCTAACCCTAACCCTAACCCTAACCCTAACCCTAACCCTAACCCTAACCCT
scaffold_100	reverse	TTAGGGTTAGGGTTAGGTTTAGGGTTAGGTTAGGTTAGGGTTAGGGTTAGGGTTAGGGTTAGGGTTAGGGTTAGGGTTAGGGTTAGGGTTAGGGTTAGGG
scaffold_101	forward	CCCTAACCCTAACCCTAACCCTAACCCTAACCCTAACCCTAACCCTAACCCTAACCCTAAACCTAACCTAACCCTAACCTAACAGGCGTACAAACGCTTC
scaffold_148	reverse	GCTTGTTCACCTGCGTCGTGTGTGGGGCATCCGAGTCAGGGTTAGGTTAGGGTTAGGGTTAGGGTTAGGGTTAGGGTTAGGGTTAGGTTAGGGTTAGGGT

Telomeres found: 32 (13 forward, 19 reverse)
