scaffold_1	forward	CCCTAACCCTAACCCTAACCCTAACCCTAACCCTAACCCTAACCCTAACCCTAACCCTAACCCTAGCCCTAAGATGCTCAGCTTGCAATGAATCTCCAAT
scaffold_2	reverse	GAGCTTGTCAGCTACCTGTCGAGCGGCCGAGCAACCTGTGCGAGAATTAGGGTTAGGGTTAGGGTTAGGGTTAGGGTTAGGGTTAGGGTTAGGGTTAGGG
scaffold_3	reverse	TGACACTCCCCTCTAGTTCGGCTTGACGCTTTCTCTGCACCTAGGGTTAGGGTTAGGGTTAGGGTTAGGGTTAGGGTTAGGGTTAGGGTTAGGGTTAGGG
scaffold_4	forward	CCCTAACCCTAACCCTAACCCTAACCCTAACCCTAACCCTAACCCTAACCCTAACCTCGTCACGACGGCCGACACGGTCCACGCCGCGGCGCTCTCGGCC
scaffold_6	reverse	CAGGAAGAGAATCGTCTTCCTTTCTTAGGGTTAGGTTTAGGTTAGGGTTAGGGTTAGGTTAGGGTTAGGGTTAGGGTTAGGGTTAGGGTTAGGGTTAGGG
scaffold_9	forward	ACCCTAACCCTAACCCTAACCCTAACCCTAACCCTAACCCTAACCCTAACCCTACTCCTAACCCTAACCCTAACCCTAACCCTAACCCTAACCCTAAGAG
scaffold_10	reverse	TTGTGAAGCGTTAGGGTTAGGGTTAGGGTTAGGGTTAGGGTTAGGGTTAGGGTTAGGGTTAGGGTTAGAGTTAGGGTTAGGGTTAGGGTTAGGGTTAGGG
scaffold_11	reverse	CCGAGCGCGAAAGCTCTTAGGGTTAGGGTTAGGGTTAGGGTTAGGGTTAGGGTTAGGGTTAGGGTTAGGGTTAGGGTTAGGGTTAGGGTTAGGGTTAGGG
scaffold_24	forward	CCCTAACCCTAACCCTAACCCTAACCCTAACCCTAACCCTAACCCTAACCCTAACCCTACCCCTAACCCTAACCCTAACCCTAACCCTAAGGGGTGATGA
scaffold_26	forward	CCCTAACCCTAACCCTAACCCTAACCCTAACCCTAACCCTAACCCTAACCCTAACCCTAAGCCTAACCCTAACCCTAAGAGGCAAGAAGCGAGTCACATT
scaffold_32	forward	CCCTAACCCTAACCCTAACCCTAACCCTAACCCTAACCCTAACCCTAACCCTAACCCTAACTCTAGCCCTAACCCTAACCCTAACCCTAACTCTAACCCT
scaffold_33	forward	CCCTAACCCTAACCCTAACCCTAACCCTAACCCTAACCCTAACCCTAACCCTAACCCTAACCCTAACCCTAACCCTGACCCGACCCTCAAGCTGTGGAAG
scaffold_35	reverse	CCCTCTAGTTCGGGTTAGGGTTAGGGTTAGGGTTAGGGTTAGGGTTAGGGTTAGGGTTAGGGTTAGGGTTAGGGTTAGGGTTAGGGTTAGGGTTTGGGTT
scaffold_38	forward	CCCTAACCCTAACCCTAACCCTAACCCTAACCCTAACCCTAACCCTAACCCTAACTCTAACCTTACCCTAACCTAACCCTAACCCTAACCCTAACCCTGA
scaffold_39	forward	CCCTAACCCTAACCCTAACCCTAACCCTAACCCTAACCCTAACCCTAACCCTAACCTAGCCCTAACCCTACCCCTACCCTAACTCTAGCCCTAACCCTAA
scaffold_49	forward	CCCTAACCCTAACCCTAACCCTAACCCTAACCCTAACCCTAACCCTAACCCTAACCCTAACCCTAACCCTAACCCTGACCCTAACCTGCTGCAACCTCTA
scaffold_57	reverse	GGGTTAGGGTTAGGGTCAGGGTTAGGGTCAGGGTTAGGGTTAGGGTTAGGGTTAGGGTTAGGGTTAGGGTTAGGGTTAGGGTTAGGGTTAGGGTTAGGGT
scaffold_64	reverse	CAGGCACAGGTTAGGGTTAGGGTTAGGGTTAGGGTAAGGGTTAGGGTTAGGGCTAGGGTTAGGGTTAGGGTTAGGGTTAGGGTTAGGGTTAGGGTTAGGG
scaffold_71	reverse	ACTCTGCACCTCCGTCTCGGCCCTCCTTAGGGTTAGGGTTAGGGTTAGGGTTAGGGTTAGGGTTAGGGTTAGGGTTAGGGTTAGGGTTAGGGTTAGGGTT
scaffold_76	reverse	GTTAGGTTAGGGTTAGGTTAGGTTAGGGTTAGGGTTAGGGTTAGGGTTAGGGTTAGGGTTAGGGTTAGGGTTAGGGTTAGGGTTAGGGTTAGGGTTAGGG
scaffold_91	reverse	AGGGCTAGGGCTAAGGTTAGGGTCAGGGTTAGGGTTAGGGTTAGGGTTAGGGTTAGGGTTAGGGTTAGGGTTAGGGTTAGGGTTAGGGTTAGGGTTAGGG
scaffold_92	forward	CCCTAACCCTAACCCTAACCCTAACCCTAACCCTAACCCTAACCCTAACCCTAACCCTAACCCTAAGTCCTCGACTCGGCTCGACACGGCACACGCGCAG
scaffold_94	reverse	CTTCAGCCAGCCCCGCCTTAGGGTTAGGGTTAGGGTTAGGTTAGGGTTAGGGTTAGGGTTAGGGTTAGGGTTAGGGTTAGGGTTAGGGTTAGGGTTAGGG
scaffold_118	forward	CCCTAACCCTAACCCTAACCCTAACCCTAACCCTAACCCTAACCCTAACCCTAACCCTAACCCTAACCCTAACGACGAAGGGAAAATCGAGTTGCAGGTG
scaffold_142	forward	CCCTAACCCTAACCCTAACCCTAACCCTAACCCTAACCCTAACCCTAACCCTAACCCTAACCCTAACCCTAGCCCTAACCCTAACCCTAACCCTAACCCT
scaffold_144	forward	CCCTAACCCTAACCCTAACCCTAACCCTAACCCTAACCCTAACCCTAACCCTAACCCTAACCTAACCCTAACCCTAAGATGGCTCAGCTTTCGTGGAGAC
scaffold_149	forward	CCCTAACCCTAACCCTAACCCTAACCCTAACCCTAACCCTAACCCTAACCCTAACCCTAACCTAAGGACTCGCTCAGACGACAAGGGCTCGCGAGCTAGA
scaffold_155	reverse	GTGCAACTGAGCGGTAGGCCTCTTAGGGTTAGGGTTAGGGTTAGGGTTAGGGTTAGGGTTAGGGTTAGGGTTAGGGTTAGGGTTAGGGTTAGGGTTAGGG
scaffold_179	reverse	CGAGTTCGACTTAGGGTTAGGGTTAGGGTTAGGGTTAGGGTTAGGGTTAGGGTTAGGGTTAGGGTTAGGGTTAGGGTTAGGGTTAGGGTTAGGGTTAGGG
scaffold_221	forward	CCCTAACCCTAACCCTAACCCTAACCCTAACCCTAACCCTAACCCTAACCCTAACTCTCTGAAGACCCGACGACGATGCAGGACGGGGCACGATGAGCGA

Telomeres found: 30 (16 forward, 14 reverse)
