scaffold_4	forward	CCCTAACCCTAACCCTAACCCTAACCCTAACCCTAACCCTAACCTAACCCTAACCTAACCCTAAACCTAACCTATCCCCTCGCAAAAGAGCTGACAAAGT
scaffold_6	forward	CCCTAACCCTAACCCTAACCCTAACCCTAACCCTAACCCTAACCCTAACCCTAACCCTAACCCTTTACCCTTAATCCATAACCTGACCCTAAGCCTAACC
scaffold_12	reverse	CTTTCTCCCTTCTCTTGCTCTCCATTCGGTTAGGGTTAGGGTTAGGTTAGGGTTAGGGTTAGGGTTAGGGTTAGGGTTAGGGTTAGGGTTAGGGTTAGGG
scaffold_17	forward	CCCTAACCCTAACCCTAACCCTAACCCTAACCCTAACCCTAACCCTAACCCTAACCCTAACCCTAACCCTAACCCTTGCGCCAACCGGTCCCACATCCTC
scaffold_19	forward	CCCTAACCCTAACCCTAACCCTAACCCTAACCCTAACCCTAACCCTAACCCTAACCCTAACCCTAACCCTAACCCTTCTCGCTCTCTGATCAAGTCTGAC
scaffold_20	forward	AACCCTAACCCTAACCCTAACCCTAACCCTAACCCTAACCCTAACCCTAACCCTAACCGCAGGATCGAGTCAACCCGCGCACGTCGGAGCGCAGTACAGC
scaffold_22	reverse	CATGGAGCTGAAACTTGAGCAAAGTGCTTCCCACCAAGGTTAGGGTTAGGGTTAGGGTTAGGGTTAGGGTTAGGGTTAGGGTTAGGGTTAGGGTTAGGGT
scaffold_28	reverse	GCCAGTTCAGAACATGCAGCTTGGGCATGTAGGGTTAGGGTTAGGGTTAGGGTTAGGGTTAGGGTTAGGGTTAGGGTTAGGGTTAGGGTTAGGGTTAGGG
scaffold_32	forward	CCCTAACCCTAACCCTAACCCTAACCCTAACCCTAACCCTAACCCTAACCCTAACCCTAACCCTAACCTTAACCTATCCTAACCCTAACCTAACCTACTT
scaffold_40	reverse	TGCAGGGACCTGGGCGCAACCGAGAGGTTAGGGTTAGGGTTAGGGTTAGGGTTAGGGTTAGGGTTAGGGTTAGGGTTAGGGTTAGGGTTAGGGTTAGGGT
scaffold_42	forward	CCCTAACCCTAACCCTAACCCTAACCCTAACCCTAACCCTAACCCTAACCCTAACCTAACCCTAACCTAACCCCTAAGACTCCCGCGGCTCGAAAGGAAC
scaffold_44	reverse	ATCTACAGAAGTTGGCCTGTTAGAGTCGGTTAGAGCTGTTAGGGCCGTTAGGGTTAGGGTTAGGTTAGGGTTAGGGTTAGGGTTAGGGTTAGGGTTAGGG
scaffold_45	forward	CCCTAACCCTAACCCTAACCCTAACCCTAACCCTAACCCTAACCCTAACCCTAACCTTACCCCTAATCCTAACCCTAAGTAACCCTAACCTAACCTAACC
scaffold_47	forward	CCCTAACCCTAACCCTAACCCTAACCCTAACCCTAACCCTAACCCTAAACCTAACCTAACCCTAACCTAACAGGCGTACAAACGCTTCTATTCGCACATT
scaffold_50	forward	CCCTAACCCTAACCCTAACCCTAACCCTAACCCTAACCCTAACCCTAACCCTAACCCTAACCTAACCCTAACCATCTGAGTGTAGCCACGAGCACTATAG
scaffold_52	reverse	GGGTGGTCTCCTTCTTGAAGGCGCGCTCTTAGGGTTAGGGTTAGGGTTAGGGTTAGGGTTAGGGTTAGGGTTAGGGTTAGGGTTAGGGTTAGGGTTAGGG
scaffold_59	forward	CCCTAACCCTAACCCTAACCCTAACCCTAACCCTAACCCTAACCCTAAACATAACCCTAACCCTAACCCTAACCTAACCCTAACCTAACCCTAAGCTCTG
scaffold_67	forward	ACCCTAACCCTAACCCTAACCCTAACCCTAACCCTAACCCTAACCCTAACCCTAACCCTAACCCTAACCTAACCTAACCGAGTCGTAGGGAGGGCAAGTT
scaffold_70	forward	ACCCTAACCCTAACCCTAACCCTAACCCTAACCCTAACCCTAACCCTAACCCTAACCCTAACCTAAGGCTGCCCCGATGCGACGGCTGCCCCAGCTTGAA
scaffold_72	reverse	CGACGGGTCTCCTCAGCCAGAGATGCTAGGTTAGGTTAGGTTAGGGTTAGGGTTAGGGTTAGGGATAGGGTTAGGGTTAGGGTTAGGGTTAGGGTTAGGG
scaffold_76	forward	AACCCTAACCCTAACCCTAACCCTAACCCTAACCCTAACCCTAACCCTAATCCTAACCCTAACCCTTCGACACTGACAACTGTTCCCGCGCTAACAGGAC
scaffold_78	reverse	GTCGCGTTCTTCCGCAAGCACTGCGTTTGTTAGGGTTAGGTTAGGGTTAGGGTTAGGGTTAGGGTTAGGGTTAGGGTTAGGGTTAGGGTTAGGGTTAGGG
scaffold_89	reverse	AAATCTTGCGTTGGCGCTATGGTTAGGGTTATGGTTAGGATTAGGGTTAGGGTTAGGGTTAGGGTTAGGGTTAGGGTTAGGGTTAGGGTTAGGGTTAGGG
scaffold_91	forward	CCCTAACCCTAACCCTAACCCTAACCCTAACCCTAACCCTAACCCTAACCTAACACTAACCCTAACCCTAACCCATAGCCGCTTGCCCAGCGTATCCGGG
scaffold_95	reverse	CTATGCTTGGAATGCACTCAAAACTTAGGGTTAGGGTTAGGTTAGGGTTAGGTTAGGGTTAGGGTTAGGTTAGGGTTAGGGTTAGGGTTAGGGTTAGGGT
scaffold_97	forward	CCCTAACCCTAACCCTAACCCTAACCCTAACCCTAACCCTAACCCTAACCCTAACCTAACCTAACCAACGAGGGTCCAGACTGTGGCCCTAGCAGAATCG
scaffold_105	reverse	GGTTAGTTAGGGTTAGGGTTAGGGTCAGGGTTAGGGTTAGGGTTAGGGTTAGGGTTAGGGGAGCGCCTACTCGTGGCTCCAGCGCGGTGATGCCAAATCC
scaffold_106	reverse	CCAAAATGCTCGAGGGTTAGGGTTAGGGTTAGGTTAGGGTTAGGGTTAGGTTAGGGTTAGTGTTAGGGTTAGGGTTAGGGTTAGGGTTAGGGTTAGGGTT
scaffold_108	reverse	TCTCAACGTCGGTGTACAGTACTCGGTTAGGGTTAGGGTTAGGGTTAGGGTTAGGGTTAGGGTTAGGGTTAGGGTTAGGGTTAGGGTTAGGGTTAGGGTT
scaffold_112	forward	CCCTAACCCTAACCCTAACCCTAACCCTAACCCTAACCCTAACCATAACCCTAACCCTAACCCTAACATAACACAAATTCGAGCTCCGTTGAACGGACAA
scaffold_114	forward	CCCTAACCCTAACCCTAACCCTAACCCTAACCCTGACCCTAACCCTAACCCTAACCCTAACCCTAACCTAACCTAACCCTAAACCTAACCCTAACCCTAA
scaffold_190	forward	CCCTAACCCTAACCCTAACCCTAACCCTAACCCTAACCCTAACCCTAACCCTAACCCTAACCCTGAGCGCGGGGGCGGCGAGGGCAGCGGGCAGGTGTGG

Telomeres found: 32 (19 forward, 13 reverse)
