scaffold_6	forward	CCCTAACCCTAACCCTAACCCTAACCCTAACCCTAACCCTAACCCTAACCTAACCCTAAGGTCGTCAAGCGTACACTCGAGCCCTCGTACAGACTCGCGA
scaffold_9	forward	CCCTAACCCTAACCCTAACCCTAACCCTAACCCTAACCCTAACCCTAACCCTAACCCTAACCCTTTACCCCTAATCCATAACCTGACCCTAAGCCTAACC
scaffold_16	reverse	CCCTTCTCTTGCTCTCCATTCGGTTAGGGTTAGGGTTAGGTTAGGGTTAGGGTTAGGGTTAGGGTTAGGGTTAGGGTTAGGGTTAGGGTTAGGGTTAGGG
scaffold_18	reverse	GCCCGCTCATTTTTTAGGGTTAGGTTAGGGTTAGTTAGGATTAGGGTTAGGGTTAGGGTTAGGGTTAGGGTTAGGGTTAGGGTTAGGGTTAGGGTTAGGG
scaffold_20	reverse	GAAAGGGGTCAGACTTGATCAGAGAGCGAGAAGGGTTAGGTTAGGGTTAGGGTTAGGGTTAGGGTTAGGGTTAGGGTTAGGGTTAGGGTTAGGGTTAGGG
scaffold_21	reverse	TGCGGTTAGGGTTAGGGTTAGGGTTAGGGTTAGGGTTAGGGTTAGGTTAGGGTTAGGGTTAGGGTTAGGGTTAGGGTTAGGGTTAGGGTTAGGGTTAGGG
scaffold_23	reverse	ATGACTATGCAGGGACCTGGGCGCAACCGAGAGGTTAGGGTTAGGGTTAGGGTTAGGGTTAGGGTTAGGGTTAGGGTTAGGGTTAGGGTTAGGGTTAGGG
scaffold_24	forward	CCCTAACCCTAACCCTAACCCTAACCCTAACCCTAACCCTAACCCTAACCCTAACCCTAACCCTAACCCTAACCCTAACCTAACCGACCCACGCTTGCCG
scaffold_27	forward	CCCTAACCCTAACCCTAACCCTAACCCTAACCCTAACCCTAACCTAACCTAACCCTAACCTAACCCTAACCCTAACCCTCGCCGCCTACGTGACCGTTCT
scaffold_28	forward	CCCTAACCCTAACCCTAACCCTAACCCTAACCCTAACCCTAACCCTAACCTAACCCTAACCTAACCCTTCGACACTGACAACTGTTCCCGCGCTAACAGG
scaffold_29	forward	CCCTAACCCTAACCCTAACCCTAACCCTAACCCTAACCCTAAACCTAACCCTAACCCTAACCTAACCCTAAACCTAACCTATCCCTAAACCTAACCTATC
scaffold_34	reverse	AGCACACTGTTTCCCAGCAAGTAGGTTAGGTTAGGGTTAGGATAGGTTAGGGTTAGGGTTAGGGTTAGGGTTAGGGTTAGGGTTAGGGTTAGGGTTAGGG
scaffold_41	forward	ACCCTAACCCTAACCCTAACCCTAACCCTAACCCTAACCTAACCCTAAACCTAACCCTAACCCTAACCCTAAATTTTAACACTACTGGCCAAGGAGAACC
scaffold_42	reverse	CGGAAGGTTAGGTTAGGTTAGGGTTAGGGTAAGGGTTAGATTAGAGTTAGGTTAGGGTTAGGGTTAGGGTTAGGGTTAGGGTTAGGGTTAGGGTTAGGGT
scaffold_44	reverse	CGTTCTGGAACCGGTGTCCATGCAACACTTTGCCACCTCTACGTCGTCGCCCTTAGGGTTAGGGTTAGGGTTAGGGTTAGGGTTAGGGTTAGGGTTAGGG
scaffold_45	forward	CCCTAACCCTAACCCTAACCCTAACCCTAACCCTAACCCTAACCCTAACCCTAACCCTAACCATAACCCTAACCCTAACCTAACCCTAACCTAACCCTAA
scaffold_46	forward	CCCTAACCCTAACCCTAACCCTAACCCTAACCCTAACCCTAACCCTAACCCTAACCCTAACCCTAGCCCTAACCCTAACCCTAACCTAACCTAACCGAGT
scaffold_48	forward	CCCTAACCCTAACCCTAACCCTAACCCTAACCCTAACCCTAACCCTAACCCTAACTCTAACCTAACCCTAACCTAACCCTAACCATCTGAGTGTAGCCAC
scaffold_50	forward	ACCCTAACCCTAACCCTAACCCTAACCCTAACCCTAACCCTAACCTAACCCTAACCCTAACCCGTGCCCAGGCGGGTATCGAGAGGGAACCGGGCGACAG
scaffold_58	forward	CCCTAACCCTAACCCTAACCCTAACCCTAACCCTAACCCTAACCCTGACCCTAACCTAATCTAACCTAACCCTAACCCTAACCCTTATCGAAAGCTCGGA
scaffold_61	forward	CCCTAACCCTAACCCTAACCCTAACCCTAACCCTAACCCTAACCCTAACCCTAACCCTAACCCTAACCGAGTACTGTACACCGACGTTGAGACGAGAGTT
scaffold_67	reverse	GCGCGCTGCCATGTTCAAGACCCTTTCCTCGAGTTCTTAGGTTAGGGTTAGGGTTAGGTTAGGGTTAGGGTTAGGGTTAGGGTTAGGGTTAGGGTTAGGG
scaffold_71	forward	CCCTAACCCTAACCCTAACCCTAACCCTAACCCTAACCCTAACCCTAACCTAACCTAACCTAACCTAGCATCTCTGGCTGAGGAGACCCGTCGAGTCAAA
scaffold_76	forward	CCCTAACCCTAACCCTAACCCTAACCCTAACCCTAACCCTAACCCTAACCCTAACCTAACCCTAAGTAACCCTAACCGCATTGCCTTGACTGTCCTGCAC
scaffold_78	reverse	ACCAGCGCCCTCTAGTGTAAATCTTGCGTTGGCGCTATGGTTAGGGTTAGGGTTAGGGTTAGGGTTAGGGTTAGGGTTAGGGTTAGGGTTAGGGTTAGGG
scaffold_91	forward	CCCTAACCCTAACCCTAACCCTAACCCTAACCCTAACCCTAACCCTAACCCTAACCCTAACCCTAACCCTAACCCTAACCCTCGAGCATTTTGGTCGACG
scaffold_93	reverse	CGATGTTTCTCTTCGACCAACTCTTTGTCTTAGGGTTAGGGTTAGGTTAGGGTTAGGGTTAGGGTTAGGGTTAGGGTTAGGGTTAGGGTTAGGGTTAGGG
scaffold_94	forward	CCCTAACCCTAACCCTAACCCTAACCCTAACCCTAACCCTAACCCTAACCCTAACCCTAACCCTAACCCTAACCTAACCCTAACCCTAACCTGTGCGTGA
scaffold_99	reverse	TTTACGCTGGTTCGACCAGAAAGGATATAGAGACCTTAGGGTTAGGGTTAGGGTTAGGTTAGGGTTAGGGTTAGGGTCAGGGTTAGGGTTAGGGTTAGGG

Telomeres found: 29 (17 forward, 12 reverse)
