scaffold_1	reverse	TCTCTCTTTCCTATGCTTTTGGCGTCGGGATGGGTTAGGGTTAGGGTTAGGGTTAGGGTTAGGGTTAGGGTTAGGGTTAGGGTTAGGGTTAGGGTTAGGG
scaffold_2	reverse	CCGTTTGCAAGGCTAGGTTAGGTTAGGTTAGGTTAGGGTTAGGTTAGGGGGTTAGGTTAGGTTAGGTTAGGTTAGGGTTAGGTTAGGGTTAGGGTTAGGG
scaffold_3	reverse	ATTAGGGTTAGGTTAGGGTTAGGTTAGGGTTAGGGTTAGGTTAGGGTTAGGGTTAGGGTTAGGGTTAGGGTTAGGGTTAGGGTTAGGGTTAGGGTTAGGG
scaffold_6	forward	CCCTAACCCTAACCCTAACCCTAACCCTAACCCTAACCCTAACCCTAACCTAACCCTAACCCTAACCCTAACCCTAACCCTAGCCACAGCGCCAACGCAA
scaffold_8	forward	CCCTAACCCTAACCCTAACCCTAACCCTAACCCTAACCCTAACCCTAACCCTAACCCTAACCCTAACCCTAACCCTAACCCTAACCTAACCGTTGTGCGA
scaffold_9	forward	CCCTAACCCTAACCTAACCTAACCTAACCCTAACCTAACCCTAACCCTAACCTAACCTAACCCTAACCCTAACCTAACCCTAACCCTAACCTCTAGCCTT
scaffold_10	reverse	GGTTAGGGTTAGGTTAGGGTTAGGTTAGGGTTAGGTTAGGGTTAGGTTAGGGTTAGGGTTAGGGTTAGGGTTAGGGTTAGGGTTAGGGTTAGGGTTAGGG
scaffold_13	forward	ACCCTAACCCTAACCCTAACCCTAACCCTAACCCTAACCCTAACCCTAACCCTAACCTAACCCTAACCTAACCTAACCCTAACCCTAACCTAAGTCAGCG
scaffold_14	forward	CCCTAACCCTAACCCTAACCCTAACCCTAACCCTAACCCTAACCCTAACCCTAACCCTAACCTAACCCTAACCTAGCCCTAACCCTAACCTAACCTAACC
scaffold_18	forward	CCCTAACCCTAACCCTAACCCTAACCCTAACCCTAACCCTAACCCTAACCCTAACCCTAACCCTAAACCTAAAAAAATGAGCGGGCGATGGGCGGGGCGG
scaffold_19	reverse	GGGTTAGGGTTAGGGTTAGGTTAGGGTTAGGGTTAGGGTTAGGGTTAGGGTTAGGGTTAGGGTTAGGGTTAGGGTTAGGGTTAGGGTTAGGGTTAGGGTT
scaffold_21	reverse	GAAGAGCTTACACCACTGAGGGCTTAGGGTTAGGTTAGGGTTAGGGTTAGGGTTAGGGTTAGGGTTAGGGTTAGGGTTAGGGTTAGGGTTAGGGTTAGGG
scaffold_37	reverse	CGCGCGTGAGGGCGCCCTGCTCTTAGGGGTTAGGTTAGGGTTAGGGTTAGGGTTAGGGTTAGGGTTAGGGTTAGGGTTAGGGTTAGGGTTAGGGTTAGGG
scaffold_38	reverse	CTTGTACTTAGGGTTAGGGTTAGGGTTAGGGTTAGGTTAGGGTTAGGGTTAGGTTAGGGTTAGGTTAGGGTTAGGGTTAGGGTTAGGGTTAGGGTTAGGG
scaffold_43	forward	CCCTAACCCTAACCCTAACCCTAACCCTAACCCTAACCCTAACCTAACCCTAACCTAACCCTAACCCCTGCCAGCAGAGGTGAGAGCGGCCCCCGTGCGC
scaffold_48	reverse	TGGTCAAAATGAGGGAATAGGGTTAGGGTTAGGGTTAGGGTTAGGGTTAGGGTTAGGGTTAGGGTTAGGGTTAGGGTTAGGGTTAGGGTTAGGGTTAGGG
scaffold_57	forward	CCCTAACCCTAACCCTAACCCTAACCCTAACCCTAACCCTAACCCTAACCCTAACCCTAACCCTAACCCTAACCCTAACCCTAAGGTCGCCACTTGAGCC
scaffold_62	forward	CCCTAACCCTAACCCTAACCCTAACCCTAACCCTAACCCTAACCCTAACCCTAACCCTAACCCTAACCCTAACCTAACCCCGAGAAAAGGCGGTTCCGAC
scaffold_65	reverse	TCCCACCGCCACTATGTGTTAGGTTAGGGTTAGGGTTAGGTTAGGGTTAGGGTTAGGGTTAGGGTTAGGGTTAGGGTTAGGGTTAGGGTTAGGGTTAGGG
scaffold_70	reverse	GTTAGGTTAGGTTAGTGTTAGGGTTAGGGTTAGGGTTAGGGTTAGGGTTAGGGTTAGGGTTAGGGTTAGGGTTAGGTTAGGGTTAGGGTTAGGGTTAGGG
scaffold_73	forward	CCCTAACCCTAACCCTAACCCTAACCCTAACCCTAACCCTAACCCTAACCCTAACCTAACCCTAACCCTAACCCTAACCTAACCATAACCTAACCCTAAG
scaffold_74	reverse	ATTAGGGGATTATAGGGTTAGGGTTAGGTTAGGTTAGGGTTAGGGTTAGGTTAAGGGGTTAGGGTTAGGGTTAGGGTTAGGGTTAGGGTTAGGGTTTGGG
scaffold_79	reverse	GCAGTCTTCACATTGCTTGAGTTAGAGTTAGGGTTAGGGTTAGGGTTAGGGTTAGGGTTAGGGTTAGGGTTAGGGTTAGGGTTAGGGTTAGGGTTAGGGT
scaffold_82	reverse	GCGAGATGGACCAACCGCACCAGTTCGGTTAGGGTTAGGGTTAGGGTTAGGGTTAGGGTTAGGGTTAGGGTTAGGGTTAGGGTTAGGGTTAGGGTTAGGG
scaffold_86	forward	CCCTAACCCTAACCCTAACCCTAACCCTAACCCTAACCCTGACCCTAACCCTAACCCTAACCCTGACCTTGACCTTAACCTTGACCCTAACCCTGCGGTT
scaffold_88	reverse	AGATTCAAGATCGTGCACCCGCAACCGCTTAGGTTAGGGTTAGGGTTAGGGTTAGGGTTAGGGTTAGGGTTAGGGTTAGGGTTAGGGTTAGGGTTAGGGT
scaffold_89	reverse	CGGATAGTCGCGCAAGGGTTAGGGTTAGGTTAGGGTTAGGGTTAGGTTAGAGTTAGGGTTAGGGTTAGGGTTAGGGTTAGGGTTAGGGTTAGGGTTAGGG
scaffold_126	reverse	AGGATTAGGATTAGGGTTAGGGTTAGGGTTAGGGTTAGGGTTAGGGTTAGGGTTAGGGTTAGGGTTAGGGTTAGGGTTAGGGTTAGGGTTAGGGTTAGGG
scaffold_137	forward	CCCTAACCCTAACCCTAACCCTAACCCTAACCCTAACCTAACCCTAACCCTAACCCTAACCCTAACCCTAACCCTAACCCTAACCTCACATCAAGACTTT
scaffold_152	reverse	TCAACTCGGTCTTCCCTGCGCTGACTTAGGGTTAGGGTTAGGGTTAGGGTTAGGTTAGGTTAGGGTTAGGTTAGGGTTAGGGTTAGGGTTAGGGTTAGGG
scaffold_156	reverse	CAGCTTGACCACCTCAGAGTCAGCAACACTTAGGTTAGGGTTAGGGTTAGGGTTAGGGTTAGGGTTAGGGTTAGGGTTAGGGTTAGGGTTAGGGTTAGGG
scaffold_161	reverse	CTGGCTCTGGTACAGGTTGCAAGCGTTAGGTTAGGGTTAGGTTAGGGTTAGGTTAGGGTTAGGGTTAGGGTTAGGGTTAGGGTTAGGGTTAGGGTTAGGG
scaffold_165	reverse	CATCCTGGCATGTGTGCATCCGAGGAGGGGTTAGGTTAGGGTTAGGTTAGGGTTAGGTTAGGGTTAGGGTTAGGGTTAGGGTTAGGGTTAGGGTTAGGGT
scaffold_169	forward	ACCCTAACCCTAACCCTAACCCTAACCCTAACCCTAACCCTAACCCTAACCCTAACCCTAACCCTAACCCTAACCCTAACCCTGACCCTAACCAGCAAGA
scaffold_170	forward	CCCTAACCCTAACCCTAACCCTAACCCTAACCCTAACCCTAACCCTAACCCTAACCCTAACCCTAACCCTAACCCTAACCCTGACCCTAACCCTGCAATC
scaffold_177	forward	CCCTAACCCTAACCCTAACCCTAACCCTAACCCTAACCCTAACCTTAACCTAACCATAACCTAACCCTAAACCTAACTGACCCTAAACCTAACCTAACCC
scaffold_179	reverse	GACAGAGCGTTCCCCTCACAACTTAGGGTTAGGGTTAGGGTTAGGGTTAGGGTTAGGGTTAGGGTTAGGGTTAGGGTTAGGGTTAGGTTAGGGTTAGGGT
scaffold_180	forward	CCCTAACCCTAACCCTAACCCTAACCCTAACCCTAACCCTAACCCTAACCCTAACCCTAACCTTAACCCTAACTCTAACCTTAGCTCTAACTCTAGCCTT
scaffold_184	reverse	TAGGGTTAGGGTTAGGTTAGGGTTAGGGTCAGGTTAGGTTAAGGGTTAGGTTTTAGGGTTAGGGTTAGGGTTAGGGTTAGGGTTAGGGTTAGGGTTAGGG
scaffold_190	reverse	CGTCGATTAGGTTAGGGTTAGGTTAGGGTTAGGGTTAGGGTTAGGGTCAGGGTTAGGGTTAGGGTTAGGGTTAGGGTTAGGGTTAGGGTTAGGGTTAGGG
scaffold_193	forward	CCCTAACCCTAACCCTAACCCTAACCCTAACCCTAACCCTAACCCTAACCCTAACCCTAACCCTAACCCTAGTGTTAACCCTGACCCTAACCCTAGCCCT
scaffold_201	forward	GCCCTAACCCTAACCCTAACCCTAACCCTAACCCTAACCCTAACCCTAACCCTAACCTAACCTAACCTTGCAACACAACCTATGAAAGGGAAGCTAGCGC
scaffold_205	forward	CCCTAACCCTAACCCTAACCCTAACCCTAACCCTAACCCTAACCCTAACCCTAACCCTGACCTAACCCTAACCTTAAGCGAGGAATGGAGTCGGCAGCTG
scaffold_223	forward	CCCTAACCCTAACCCTAACCCTAACCCTAACCCTAACCCTAACCCTAACCCTAACCCTAACCCTAACCTTGGGCGAGGTTCCGAGGAGGACGGGGGCCTT
scaffold_227	reverse	ACTTTTCGAAATAGTGGGGTTAGGTTTAGGGTTAGGTTAGGTTAGGGTTAGGTTAGGGTTAGGGTTAGGGTTAGGGTTAGGGTTAGGGTTAGGGTTAGGG
scaffold_228	forward	GACAGCCCTAACCCTAACCCTAACCCTAACCCTAACCCTAACCCTAACCCTAGCCCTAACCCTAACCTAACCCTAACCCTAACCTGGAGAATGATGTCCA
scaffold_233	forward	ACCCTAACCCTAACCCTAACCCTAACCTAAACCTAACCCTAACCCTAACCCTAACCCTAACCCTAACCCTAACCCTAACCCTAACCCTAGCCCTAGCCCT
scaffold_244	forward	ACCCTAACCCTAACCCTAACCCTAACCCTAACCCTAACCCTAACCCTAACCCTAACCCTAACCTGTTTGATCCGCCGTTCACGCTCTGAGCGCTCAGAGG
scaffold_245	forward	CCCTAACCCTAACCCTAACCCTAACCCTAACCCTAACCCTAACCCTAACCCTAACCCTAACCCTAACCTAACCCTAACCCTAACCTAACCCTAACCCTAA
scaffold_248	reverse	GTTAGGTTAGGGTTAGGTTAGGGTTAGGGCTAGGGTTAGGTTAGGGTTAGGGTTAGGGTTAGGGTTAGGGTTAGGGTTAGGGTTAGGGTTAGGGTTAGGG
scaffold_249	forward	CCCTAACCCTAACCCTAACCCTAACCCTAACCCTAACCCTAACCCTAACCCTAACCCTAACCCAACCTAACCCTAACCTAACCCTTTGTCCAGAATGGGC
scaffold_258	forward	CCCTAACCCTAACCCTAACCCTAACCCTAACCCTAACCCTAACCCTAACCCTAACCTAACCTAACCTAACCTCCCCTCCATCCCCCTATTAGTCCGCTCG
scaffold_267	forward	CCCTAACCCTAACCCTAACCCTAACCCTAACCCTAACCCTAACCCTAACCTAACCCTAACCCTAACCCTAACCCTAACCCTAACCTAACGCACAGTCGCG
scaffold_285	forward	CCCTAACCCTAACCCTAACCCTAACCCTAACCTAACCCTAACCCTAACCCTAACCCTAAACCTAAACCTAACCCTAACCTAACCTAACTTTTCCTCTGCT
scaffold_287	forward	CCCTAACCCTAACCCTAACCCTAACCCTAACCCTAACCCTAACCCTAACCCTAACCCTAACTCTAACCTAGTCTAATCCTAACCTAACCTAACCCTAATT
scaffold_301	forward	CCCTAACCCTAACCCTAACCCTAACCCTAACCCTAACCCTAACCCTAACCCTAACCCTAACCTAACCCTAACCTAACCCTAACCTAACCCTAACCCAAAG
scaffold_310	reverse	CAAGATTGTGCTTAGGGTTAGGGTTAGGTTAGGGTTAGGGTTATGGTTAGGGTCAGGGTTAGGGTTAGGGTTAGGGTTAGGGTTAGGGTTAGGGTTAGGG
scaffold_313	reverse	GGGTTAGGTTAGTTAGGTTAGGGTTAGGCTAGGGTCATGATTAGGGTTAGGGTTAGGGTTAGGGTTAGGGTTAGGGTTAGGGTTAGGGTTAGGGTTAGGG
scaffold_321	forward	CCCTAACCCTAACCCTAACCCTAACCTAACCCTAACCCTAACCCTAACCCTAACCCTAACCCTTAACCTTAACCCTAACCCTAATCTAACCCTAACCCTA
scaffold_447	forward	CCCTAACCCTAACCCTAACCCTAACCCTAACCCTAACCCTAACCCTAACCCTAACCCTAACCTAACCCTAACCCTAACCCTAACCAGAACCGCCAACCCA
scaffold_530	reverse	TAGGGTTAGGGTTAGGGCTAGGGTTAGGTTAGGGTTAGGGTGAGGGTTAGGGTTAGGGTTAGGGTTAGGGTTAGGGTTAGGGTTAGGGTTAGGGTTAGGG

Telomeres found: 61 (32 forward, 29 reverse)
