scaffold_1	reverse	CGAAGGAGTAGCAGAACCTGGGTTAGGGTTAGGGCTAGGGCTAGGGTTAGGGTTAGGGTTAGGGTTAGGGTTAGGGTTAGGGTTAGGGTTAGGGTTAGGG
scaffold_9	reverse	TTAGGTTTAGGCTAGGGTTAGGGTTAGGTTAGGATTAGGATTAGGGTTAGGGTTAGGGTTAGGGTTAGGGTTAGGGTTAGGGTTAGGGTTAGGGTTAGGG
scaffold_18	forward	CCCTAACCCTAACCCTAACCCTAACCCTAACCCTAACCCTAACCCTAACCCTAACCCTAACCCTAACAGCCTTCCCGAGTCAAGCTGCCTAGTCCAAGTG
scaffold_19	forward	CCCTAACCCTAACCCTAACCCTAACCCTAACCCTAACCCTAACCCTAACCCTAACCCTAACCCTAGCCCTAACCCTAACCCTAACCCTAAGACATCGGAC
scaffold_27	reverse	TCGCCGTCGTCCACCGCTCGTCCTTAGGGTCAGGGTTAGGTTAGGGTTAGGGTTAGGGTTAGGGTTAGGGTTAGGGTTAGGGTTAGGGTTAGGGTTAGGG
scaffold_31	forward	CCCTAACCCTAACCCTAACCCTAACCCTAACCCTAACCCTAACCCTAACCCTAACCCTAACCCTAACGCACCTCCCCGGGCCGAGAGGCTCGACCGCTCG
scaffold_39	reverse	CACCTCGCTCGTTAGGTTAGGGTTAGGGTTGGGGCTAGGGTTAGGGTTAGGGTTAGGGTTAGGGTTAGGGTTAGGGTTAGGGTTAGGGTTAGGGTTAGGG
scaffold_46	reverse	CTGCAGGGGGGAGAGGGCCAGCTTCGGGTTAGGGCTAGGGCTAGGGTTAGGGTTAGGGTTAGGGTTAGGGTTAGGGTTAGGGTTAGGGTTAGGGTTAGGG
scaffold_48	forward	CCCTAACCCTAACCCTAACCCTAACCCTAACCCTAACCTAACCCTAACCCTAACCCTAACCCTAACCCTAACCCTGAGACCTCTCTTCTCCGCTGGCAAG
scaffold_52	forward	CCCTAACCCTAACCCTAACCCTAACCCTAACCCTAACCCTAACCCTAACCCTAACCCTAACCCTAACCTAACCTAACCCTAAGCCGCCGAGCTTGCAGCG
scaffold_54	reverse	TCCCGACCGTGCTGAGTGGGTTAGGGTTAGGGTTAGGGTTAGGGTTAGGGTTAGGGTTAGGGTTAGGGTTAGGGTTAGGGTTAGGGTTAGGGTTAGGGTT
scaffold_57	reverse	TGGCATCAACACAGAGAGAACCGCAAAAGCACAGGCTAGGTTAGGGTTAGGGTTAGGGTTAGGGTTAGGGTTAGGGTTAGGGTTAGGGTTAGGGTTAGGG
scaffold_80	reverse	TTGAGTGCGAGCCGGGTTAGGGTTAGGGTTAGGGTTAGGGTTAGGGTTAGGGTTAGGGTTAGGGTTAGGGTTAGGGTTAGGGTTAGGGTTAGGGTTAGGG
scaffold_87	forward	CCCTAACCCTAACCCTAACCCTAACCCTAACCCTAACCCTAACCCTAACCCTAACCTAACCCTAACCCTAACCCTAAGAGGGGGGTGTCACTCACCCCGA
scaffold_88	reverse	GGCGCTCGACGGTGGCTTCGAGCGCGTCTTAGGGTTAGGGTTAGGGTTAGGGTTAGGGTTAGGGTTAGGGTTAGGGTTAGGGTTAGGGTTAGGGTTAGGG
scaffold_90	reverse	ACAGCATCGCCGAGCTCTCGGTCGCCGTCTCGGGTTAGGGTTAGGGTTAGGGTTAGGGTTAGGGTTAGGGTTAGGGTTAGGGTTAGGGTTAGGGTTAGGG
scaffold_99	reverse	CTCAGTACGAAAGAGGCGTGGTTGGAGTCTTAGGGTTAGGGTTAGGGTTAGGGTTAGGGTTAGGGTTAGGGTTAGGGTTAGGTTAGGGTTAGGGTTAGGG
scaffold_107	forward	CCCTAACCCTAACCCTAACCCTAACCCTAACCCTAACCCTAACCCTAACCCTAACCCTAACCCTAACCCTAACCCTAAGATCCGCTGCTCGGGCTACCGA
scaffold_113	reverse	AGGTAGCTTGCCCCCTCTCCTCTTAGGGTTAGGGTTAGGGTTAGGGTTAGGGTTAGGGTTAGGGTTAGGGTTAGGGTTAGGGTTAGGGTTAGGGTTAGGG
scaffold_137	forward	CCCTAACCCTAACCCTAACCCTAACCCTAACCCTAACCCTAACCCTAACCCTAACCCTAACCCTAACCCTAACCCTAACCCTAACCCTAAGATGGCGGCG
scaffold_142	forward	CCCTAACCCTAACCCTAACCCTAACCCTAACCCTAACCCTAACCCTAACCCTAACCTAACCCTAACCCTAACCCTAAGAAGCAGGCTCTCACTCGAGGAA
scaffold_158	reverse	CGCCGGTCCTGCAGGGTTAGGGTTAGGGTTAGGGTTAGGGTTAGGGTTAGGGTCAGGGTTAGGGTTAGGGTTAGGGTTAGGGTTAGGGTTAGGGTTAGGG
scaffold_160	reverse	GCTCCTCGCCCTCGAGCACTCCGCCCGGCTAGGGTTAGGGTTAGGGTTAGGGTTAGGGTTAGGGTTAGGGTTAGGGTTAGGGTTAGGGTTAGGGTTAGGG
scaffold_191	reverse	CGAGCGCGAGCTGGGCCATCGGGGTGAGTTAGGGTTAGGGTTAGGGTTAGGGTTAGGGTTAGGGTTAGGGTTAGGGTTAGGGTTAGGGTTAGGGTTAGGG
scaffold_194	forward	ACCCTAACCCTAACCCTAACCCTAACCCTAACCCTAACCCTAACCCTAACCCTAACCCTAACCCTAACCCTAACCCAAAAACCTAACCCTAACCCTAAGA
scaffold_196	reverse	GTTAGGGTTAGGGTTAGGGTTAGGGTTAGGTTAGCTAGGGTTAGGGTTAGGGTTAGGGTTAGGGTTAGGGTTAGGGTTAGGGTTAGGGTTAGGGTTAGGG
scaffold_202	reverse	AGCCGCCGAGAAGCGGAAGCGAGCGTCCGGGAGGTTAGGGTTAGGGTTAGGGTTAGGGTTAGGGTTAGGGTTAGGGTTAGGGTTAGGGTTAGGGTTAGGG
scaffold_205	reverse	ACGAGCGGGACGCAGCCTGGGAAGAGTTAGGGTCAGGATCTTAGGGTTAGGGTTAGGGTTAGGGTTAGGGTTAGGGTTAGGGTTAGGGTTAGGGTTAGGG
scaffold_217	forward	CCCTAACCCTAACCCTAACCCTAACCCTAACCCTAACCTAACCCTAACCCTAACCCTAACCCTAACCCTAACCCTAACCCTAACCCTAACCCAGAGGACG
scaffold_218	reverse	AGGGTTAGGTTAGGGTTAGGGCTAGGGTTAGGGTTAGGGTTAGGGTTAGGGTTAGGGTTAGGGTTAGGGTTAGGGTTAGGGTTAGGGTTAGGGTTAGGGT
scaffold_320	reverse	TGAGCGAAACAGTAGCAAAACCTGGGACTCGGGGTTAGGGTTAGGGTTAGGGTTAGGGTTAGGGTTAGGGTTAGGGTTAGGGTTAGGGTTAGGGTTAGGG
scaffold_328	reverse	TAGTCAGGATTAGGGCTAGGGCTAGGGTTAGGGTAGAGTTAGGGTTAGGGTTAGGGTTAGGGTTAGGGTTAGGGTTAGGGTTAGGGTTTAGGGGTTAGGG

Telomeres found: 32 (11 forward, 21 reverse)
