scaffold_1	forward	CCCTAACCCTAACCCTAACCCTAACCCTAACCCTAACCCTAACCCTAACCCTAACCTAACCCTAACCTCGCGTCAACTGCGGTCCTTCGGCGCGGGCGTC
scaffold_3	forward	CTTCCCTAACCCTAACCCTAACCCTAACCCTAACCCTAACCCTAACTCTAACCCTAACTCTAACTCTAATCCTACCCCTAATCCTAACCTAACCCTAACC
scaffold_3	reverse	CACTTCGACCTTCCCTTACGGGTTAGGGTTAGGGTTAGGGTTAGGGTTAGGGTTAGGGTTAGGGTTAGGGTTAGGGTTAGGGTTAGGGTTAGGGTTAGGG
scaffold_4	reverse	GGGTTAGGGTCAGGGTTAGGGTTAGGGTTAGGGTTAAGGGTTAGGGTTAGGGTTAGGGTTAGGGTTAGGGTTAGGGTTAGGGTTAGGGTTAGGGTTAGGG
scaffold_5	forward	ACCCTAACCCTAACCCTAACCCTAATCCCTAACCCTAACCCTAGCCCTAACCCTAGCCCTAACCCTGACCCTAACCCTAACCCTAACCTTGGTTCTTAGT
scaffold_6	reverse	CATGTGCTCAGGTTAGGCTTAGGGTTACTTAGGGTTAGGGTTAGGGTTAGGGGTAGGGTTAGGGTTAGGGTTAGGGTTAGGGTTAGGGTTAGGGTTAGGG
scaffold_9	reverse	CTCATCTGCGCAGCTCTTGGGGTTAGGGTTAGGTTAGGGTTAAGGTCAGAGCTTAGGGTTAGGGTTAGGGTTAGGGTTAGGGTTAGGGTTAGGGTTAGGG
scaffold_10	forward	CCCTAACCCTAACCCTAACCCTAACCCTAACCCTAACCTCACCCTAACCCTAACCTAACCTAATCTAACCTAACCCTAACCCTAACCCTAACCCTAGGTT
scaffold_12	reverse	TGTGGGCGAGTCGATGATGTGGCGACTTCCTGTCTTAGGGTTAGGGTTAGGGTTAGGGTTAGGGTTAGGGTTAGGGTTAGGGTTAGGGTTAGGGTTAGGG
scaffold_14	reverse	TAGGGTTAGGGATAAGACTAGGGTAGGGCTAAGATTAAGGTTAGGGTTAAGGTTAGGATTAGGGTTAGGGTTAGGGTTAGGGTCAGGGTTAGGGTTAGGG
scaffold_16	reverse	TGCGCGCGAACTTAGGGTTAGGGTTAGGTTAGGGTTAGGGTTAGGGTTAAGGTTAGGGTTAGGGTTAGGGTTAGGGTTAGGGTTAGGGTTAGGGTTAGGG
scaffold_17	reverse	CTTCGTTAGGGTCAGAGTAAGACTAAGTTCAGGGTTAGGGTTAGGGTTAGGGTTAGGGTTAGGGTTAGGGTTAGGGTTAGGGTTAGGGTTAGGGTTAGGG
scaffold_20	forward	CTCACCCTAACCCTAACCCTAACCCTAACCCTAACCCTAACCCTAACCCTAACCTAACCTAACCTAACCCCTAACCCTAAGGCAGAACCGTCCCAACATC
scaffold_22	reverse	CTGCTGCGGGTCGCTCGCGCCACAATGGCTGTTCTTAGGGTTAGGGTTAGGGTTAGGGTTAGGGTTAGGGTTAGGGTTAGGGTTAGGGTTAGGGTTAGGG
scaffold_23	forward	ACCCTAACCCTAACCCTAACCTAACCCTAACCCTAACCCTAACCCGGGTCCGCAACTTTGTTCACGGTCTCACGGACCCGACTCGAGCGACACAGCACGC
scaffold_24	reverse	CTGCTGCTCCCATTCGGTTCGCGCCTGCTTAGGGTTAGGGTTAGGGTTAGGGTTAGGGTTAGGGTTAGGGTTAGGGTTAGGGTTAGGGTTAGGGTTAGGG
scaffold_32	forward	CCCTAACCCTAACCCTAACCCTAACCCTAACCCTAACCCTAACCCTAACCCTGACCCTGACCCTGACCCTGACCCTGACCCTGACCCTGACCCTGACCCT
scaffold_33	forward	CCCTAACCCCTAACCCTAACCCTAACCCTAACCCTAACCCTAACCCTAACCCTAACCCTAACCCTAACCCTAACCCTAACCCTAACCCTAACCCTAACTC
scaffold_34	forward	CCCTAACCCTAACCCTAACCCTAACCCTAACCCTAACCCTAACCCTGACCCTAACCCTAACCCTAAGGTGCCCGAGCGATGAGGGGAGGAGGCGTCGGCA
scaffold_38	reverse	AGGGTTAGGGTTAGGGTTAGGATTAGGATTAGGGTTAGGGTTAGGATTAGGATTAGGATTAGGGTTAGGGTTAGGGTTAGGGTTAGGGTTAGGGTTAGGG
scaffold_39	reverse	AGCCGCGCCGGCTTACATACACTTTGATTTAGGGTTAGGGTTAGGGTTAGGGTTAGGGTTAGGGTTAGGGTTAGGGTTAGGGTTAGGGTTAGGGTTAGGG
scaffold_40	forward	ACCCTAACCCTAACCCTAACCCTAACCCTAACCCTAACCCTAACCCTAACCCTAACCCTAACCTTAACCCTGACCTAACTCTAACCCTGACCATAGCCCT
scaffold_43	forward	CCCTAACCCTAACCCTAACCCTAACCCTAACCCTAACCCTAACCCTAACCCTAACCCTAAGTCGCGACACGATTGTGCAACTGCGCTGCTCAACTTTGCA
scaffold_51	reverse	AGAGCTGGGTCCGTACGTGCTTGCTTGCCTTAGGGTTAGGGTTGGGTTAGGGTTAGGGTTAGGGTTAGGGTTAGGGTTAGGGTTAGGGTTAGGGTTAGGG
scaffold_54	forward	TAACCCTAACCCTAACCCTAACCCTAACCCTAACCCTAACCCTAACCCTAACCCTAACCCTAACCCTAACCCTAACCTAACCCTAAGTTGCGTTCGACTC
scaffold_55	reverse	AAAAGTTGGGTCAGGGTCAGGGTGAAGGCTAGGGTTAGGGTTAGGGTTAGGGTTAGGGTTAGGGTTAGGGTTAGGGTTAGGGTTAGGGTTAGGGTTAGGG
scaffold_58	reverse	TTTTGTTGCGTTAGCGTTAGGGTTAGGGTTAGGGTTAGGGTTAGGGTTAGGGTTAGGGTTAGGGTTAGGGTTAGGGTTAGGGTTAGGGTTAGGGTTAGGG
scaffold_61	forward	CCCTAACCCTAACCCTAACCCTAACCCTAACCCTAACCCTAACCATAACCCTAACCCTAACCGTGGTCCTAACCCTAGTCCTGACCCTAACCCTAACCCT
scaffold_63	reverse	TTGCTCCCCTCCTTAGGGTTAGGGTCAAGGTCAGAACTGGGGCCACCCCAGGTTAGGGTTAGGGTTAGGGTTAGGGTTAGGGTTAGGGTTAGGGTTAGGG
scaffold_70	forward	CCCTAACCCTAACCCTAACCCTAACCCTAACCCTAACCCTAACCCTAACCCTAACCCTAACCCTGTCAGACTATGCATTGTGACCGCTGCAAAGCTACGC
scaffold_90	forward	CCCTAACCCTAACCCTAACCCTAACCCTAACCCTAACCCTAACCTAACCCTAACCTAACCCTAACCCTAACCCTAACCCTAACCTAACCCTAACCTAACC

Telomeres found: 31 (15 forward, 16 reverse)
