scaffold_5	forward	CCCTAACCCTAACCCTAACCCTAACCCTAACCCTAACCCTAACCCTAACCCTAACCCTAACCCTAACCCTAACCTAACCCTAACCCTAAGACACTTTTCG
scaffold_6	reverse	CGAAAGTGTTCAGGAATACTGCGTGAGGCTGAGGGTTAGGTTAGGGTTAGGGTTAGGGTTATGGTTAGGGTTAGGGTTAGGGTTAGGGTTAGGGTTAGGG
scaffold_8	forward	CCCTAACCCTAACCCTAACCCTAACCCTAACCCTAACCCTAACCCTAACCTAACCCTAACCTCCAAAACTTGGACCGCGTTCAATTCGCTGACGTGCGGG
scaffold_12	reverse	ATTCGGTTAGGGTTAGGGTTAGGTTAGGGTTAGGGTTAGGGTTAGGATTAGGGTTAGGGTTAGGGTTAGGTTAGGGTTAGGGTTAGGGTTAGGGTTAGGG
scaffold_16	reverse	AGGGCTCATTTTAGGTTAGGGTTAGGGTTAGGGTTAGGGTTAGGGTTAGGGTTAGGGTTAGGGTTAGGGTTAGGGTTAGGGGTTAGGGTTAGGGTTAGGG
scaffold_17	reverse	GCGTTCGCGCCCGACATGTGCGACGGCGGCTGTACTGCGCTTAGGGTTAGGGTTAGGGTTAGGGTTAGGGTTAGGGTTAGGGTTAGGGTTAGGGTTAGGG
scaffold_20	reverse	GGCTGACGGTCTGAACCGAAGGGCAACAAATCGCAATTCTCCTCACCTTAGGTTTAGGGTTAGGGTTAGGTTAGGGTTAGGGTTAGGGTTAGGGTTAGGG
scaffold_22	reverse	TATTCCAGGCCAGTCAAGTGTTAGGGTTAGGTTAGGGTTAGGTTAGGTTAGGGTTAGGTTAGGGTTAGGGTTAGGGTTAGGGTTAGGGTTAGGGTTAGGG
scaffold_33	reverse	AGTGACCGAACATCCCAGTCTTTCTGGTGCTGCGACTGATGAGCGATTTAGGTTAGGGTTAGGGTTAGGGTTAGGGTTAGGGTTAGGGTTAGGGTTAGGG
scaffold_38	forward	CCTAACCCTAACCCTAACCCTAACCCTAACCCTAACCCTAACCCTAACCCTAACCTAACCCCTAACCTGCATGGTCAAATGATGTGCCTGACGTTGCGCA
scaffold_41	reverse	TGGGGATTCTTAGGGTTAGGGTTAGGGTTAGGGTTATGGTTAGGGTTAGGGTTAGGGTTAGGGTTAGGGTTAGGGTTAGGGTAACCCTAACCCTAACCCT
scaffold_45	reverse	ACCAAGTGTGCGCTTTTTTGACTCGCTTCGGTAGGTTAGGGTTAGGTTAGGGTTAGGGTCAGGGTTAGGGTTAGGGTTAGGGTTAGGGTTAGGGTTAGGG
scaffold_46	forward	CCCTAACCCTAACCCTAACCCTAACCCTAACCCTAACCCTAACCTAACCCTAACCCTGACCCTAACCCTAACCCTAAGGACAGTGTGGCTGATCTTTGCT
scaffold_48	reverse	CACCAGCGGTAGCGCAGAAGGGCCTTTCAGTAGGGTTAGGGTTAGGTTAGGGTTAGGGTTAGGGTTAGGGTTAGGGTTAGGGTTAGGGTTAGGGTTAGGG
scaffold_49	forward	CCCTAACCCTAACCCTAACCCTAACCCTAACCTAACCCTAACCCTAACCCTAACCCTAACCTAACCTAACCCTAACCTAACCTTCCTGTGCGCTAGCCGT
scaffold_51	reverse	TTAGGGTTAGGTTAGGGTTAGGTTAGGTTTAGGGTTAGGGTTAGGGTTAGGGTTAGGGTTAGGGTTAGGGTTAGGGTTAGGGTTAGGGTTAGGGTTAGGG
scaffold_53	reverse	GCGGACATCAGTCTGCGCCAGAGGTTAGGTTAGGTTAGGGTTAGGGTTAGGGTTAGGGTTAGGGTTAGGGTTAGGGTTAGGGTTAGGGTTAGGGTTAGGG
scaffold_55	forward	CCCTAACCCTAACCCTAACCCTAACCCTAACCCTAACCCTAACCCTAACTAACCTAACCCTAACCTAACCTGAACCAGCCCAATCTACGGCCACTGGCGG
scaffold_65	forward	CCCTAACCCTAACCCTAACCCTAACCCTAACCCTAACCCTAACCCTAAGTAACCCTAACCTAACCCTAGCCCGCCAAAACGCCGAAAGCTGGCGAGTTGC
scaffold_68	forward	CCCTAACCCTAACCCTAACCCTAACCCTAACCCTAACCCTAACCCTAACCCTAACCCTAACCTAATCCGTATCGAAAACAGCAACAACGCTTACTCGGGG
scaffold_71	reverse	AAAGGCTCTATCCGATTCTGCTAGGGCCACAGTCTGGACCCTCGTTGGTTAGGTTAGGGTTAGGTTAGGGTTAGGGTTAGGGTTAGGGTTAGGGTTAGGG
scaffold_76	forward	AACCTAACCCTAACCCTAACCCTAACCCTAACCCTAACCCTAACCCTAACCTAACCCTAACCCTAACCTAACCCCTAACCTAACCTAACCCTAACCTAAC
scaffold_87	reverse	TCTTCCGCAAGCACTGGTTAGGGTTAGGGTTAGGGTTAGGGTTAGGGTTAGGTTAGGGTTAGGGTTAGGGTTAGGGTTAGGGTTAGGGTTAGGGTTAGGG
scaffold_100	forward	CCCTAACCCTAACCCTAACCCTAACCCTAACCCTAACCCTAACCCTAACCCTAACCATAGCGCCAACGCAAGATTTACACTAGAGGGCGCTGGTCACGTC
scaffold_101	reverse	CGGTGCCACCCTCGCCTTAGGGTTAGGTTAGGGTTAGGGTTAGGGTTAGGGTTAGGGTTAGGGTTAGGGTTAGGGTTAGGGTTAGGGTTAGGGTTAGGGT
scaffold_108	forward	CCCTAACCCTAACCCTAACCCTAACCCTAACCCTAACCCTAACCCTAACCCTAACCCTAACCCTAACCCTAACCCTAACCTAACCCTAACCTAACCCTAA
scaffold_114	reverse	CAGCGGGGACTGTTATTGAACATTTTCCGCTTAGTGTTAGGTTAGGTTAGGGTTAGGGTTAGGGTTAGGGTTAGGGTTAAGGTTATGGTTAGGGTTAGGG
scaffold_122	reverse	CTCGGGGCTAGGTTAGTTTGGTTAGGGGGGTTAGGCTAGGTTAGGGTTAGGGTTATGGTTAGGGTTAGGGTTAGGGTTAGGGTTAGGGTTAGGGTTAGGG
scaffold_125	reverse	TAGGGTTAGGGTTATGGTTAGGGTTAGGGTTAGGGTTAGGGTTAGGGTTAGGGTTAGGGTTAGGGTTAGGTTAGGGTTAGGGTTAGGGTTAGGGTTAGGG
scaffold_132	forward	AACCCCAACCCTAACCCTAACCCTAACCCTAACATAACACAAATTCGAGCTCCGTTGAACGGACAAGCGTCGACGCAGTTTTGGCGGCGAGAGAGCGAGT
scaffold_133	reverse	GGGTTAGGGTTAGGGGTAGGGTTAGGTTAAGGTTAGGGTTAGGGTTAGGGTTAGGGTTAGGGTTAGGGTTAGGGTTAGGGTTAGGGTTAGGGTTAGGGTT
scaffold_187	reverse	TTTTTTCCTTGCACCTGCTTGGGGATTCTTAGGGTTAGGGTTAGGGTTAGGGTTAGGGTTAGGGTTAGGGTTAGGGTTAGGGTTAGGGTTAGGGTTAGGG

Telomeres found: 32 (12 forward, 20 reverse)
