scaffold_2	forward	CCCTAACCCTAACCCTAACCCTAACCCTAACCCTAACCCTAACCCCTAACCCCTAACCCCTAACCCTGTGACCGCCATCGACGGGATCCCCCGACAGTCG
scaffold_3	forward	CCCTAACCCTAACCCTAACCCTAACCCTAACCCTAACCCTAACCCTAACCCTAAGATACTCGCCCTCTCGCTCTGCATTCACCGTCGAGTCCTTTCTCCC
scaffold_7	reverse	TTCCCACAGCTTCAGACGCTCTCTGAGGGTTGAAAAGAGGGAGGAGCTGAAGAGTGGGGACAGGGAGAGTGGGAGGTTAGGGTTAGGGTTAGGGTTAGGG
scaffold_10	forward	CCCTAACCCTAACCCTAACCCTAACCCTAACCCTAACCCTAACCCTAAACCTTTACTTGAGGCTGTGAGGGAGGTCGCTGGTCAGTAGCTGCAGAACTGG
scaffold_11	forward	ACCCTAACCCTAACCCTAACCCTAACCCTAACCCTAACCCTAAGAAAGGCAGCAGCGGGCGGCGGTAGCGACGGCCACGCAGGCACAGCGAGCAGAATTC
scaffold_14	reverse	AGCTACGCAGGGAGGAGGAGGAGGAGGACGCATGTTAGGGTTAGGGTTAGGGTTAGGGTTAGGGTTAGGGTTAGGGTTAGGGTTAGGGTTAGGGTTAGGG
scaffold_19	forward	CCCTAACCCTAACCCTAACCCTAACCCTAACCTAACCCTAACCTAACCCTAACCCTAACCCTAAGGTGCACTTGACGAGTGTGTTGAGCCTGTGTGGAGA
scaffold_22	forward	CCCTAACCCTAACCCTAACCCTAACCCTAACCCTAACCCTAACCCTAACCCTAACCCTGAAAACAGGGACCAAGTCCGGAAAAGCCGGCTTGGCCCACCT
scaffold_23	reverse	GCCTGCAAGGTCCAACGAAGTCAGCACGGTTCTTAGGGTTAGGGTTAGGGGTAGGGTTAGGGTTAGGGTTAGGGTTAGGGTTAGGGTTAGGGTTAGGGTT
scaffold_25	reverse	GCTTTCCTGGCTCTACGCATTTGTGTGCTGCTGTAACTTCGCTGGGTTAGGGTTAGGGTTAGGGTTAGGGTTAGGGTTAGGGTTAGGGTTAGGGTTAGGG
scaffold_33	forward	CCCTAACCCTAACCCTAACCCTAACCCTAACCCTAACCCTAACCCTAACCCTCAAGGGTCCCAAGCAAGAGTTGCATGCGCGGATGAAGCGACTCGAGGA
scaffold_34	forward	CCCTAACCCTAACCCTAACCCTAACCCTAACCCTAACCCTAACCCTAACCTTAACCCTAACCCTAACCCGGAGAAGGAGGCGACGGATTCACTCAAGACG
scaffold_38	reverse	TTCATTCGCTTTGACGGGGTGCCAGAGGGCGAGAGGATGGAGAGTGGAAGGGTTAGGGTTAGGGTTAGGGTTAGGGTTAGGGTTAGGGTTAGGGTTAGGG
scaffold_39	reverse	CTGCTGGTGCACAGGTTTCAACGACGAGGTCGCCTTCCAGAAAGTCTTAGGGTTAGGGTTAGGGTTAGGGTTAGGGTTAGGGTTAGGGTTAGGGTTAGGG
scaffold_40	reverse	GAGCTGCAGTTCGATAGGAAGATCAGGGGCAGGCATAGTGCGCTCGAGCGGGTTAGGGTTAGGGTTAGGGTTAGGGTTAGGGTTAGGGTTAGGGTTAGGG
scaffold_41	reverse	GAGGCGTGACGAGGACACGGAGGGACTGGAGCGGTCGCTCGAGGAGAGTGGTTGCCGCCAGGATTTAGGGTTAGGGTTAGGGTTAGGGTTAGGGTTAGGG
scaffold_47	forward	CCCTAACCCTAACCCTAACCCTAACCCTAACCCTAACCCTAACCCTAACCCTAACCCTAGTTTGCCCTCCTTTTGCTCCTGACTCGTTTTCCTCGAATTC
scaffold_49	forward	CCCTAACCCTAACCCTAACCCTAACCCTAACCCTAACCCTAACCCTAAGATTCTGCGGCGGTGCACGAGCTGACTCAGCATCTCTTGCTTGGATCGAACG
scaffold_52	reverse	CAGTCTGGTCAGTCAAGCACAGGAGAGTGTGGGAAAGTGCAAGGGGCACAGGTTGGAGCTGGTTTAGGGTTAGGGTTAGGGTTAGGGTTAGGGTTAGGGT
scaffold_53	forward	CCCTAACCCTAACCCTAACCCTAACCCTAACCCTAACCCTAACCCTATCCCTAACCCTATCCCAGCCTGAAAGAAGCGAGTTTGCTGTCCTCCTCCTGTT
scaffold_57	forward	CCCTAACCCTAACCCTAACCCTAACCCTAACCCTAACCCTAACCCTAACCCTAACCCTAACCCTAACCCTAAGCTTCGCTTCCTTTCGATCGCACACTTG
scaffold_61	forward	CCCTAACCCTAACCCTAACCCTAACCCTAACCCTAGCCCTAACCCTAACCCTAACCCTAACCCTAGACCACTGCACACATGCAGAACCGCCCCACGACGC
scaffold_66	forward	GTTAAACCCTAACCCTAACCCTAACCCTAACCCTAACCCTAACCCTAACCCTAACCCTAACCCTAAGCGGAGCGCTGCATCATCCGCGTCAAGAACTCGC
scaffold_67	reverse	AGGGCATTACTGACGCCGCTCGCTTGTACCGCAGCACGGGCCACGGTTAGGGTTAGGGTTAGGGTTAGGGTTAGGGTTAGGGTTAGGGTTAGGGTTAGGG
scaffold_70	forward	CCCTAACCCTAACCCTAACCCTAACCCTAACCCTAACCCTAACCCTAACCCTAACCCTAACCCTAACCCTAACCCCCTTCTCTTGCCCCTGTCTGGCTGA
scaffold_71	reverse	CATCAGTTCTGTGCGTTTGCCTCGTTCACTTGGCTTGCACATGGCTTGGGGCGGGATTGAAGGTTAGGGTTAGGGTTAGGGTTAGGGTTAGGGTTAGGGT
scaffold_77	forward	CCCTAACCCTAACCCTAACCCTAACCCTAACCCTAACCCTAACCCTAACCCTAACCCTAACCCCAAAACGTGCGTTCACATCCCTCTCCTCGCTCGAGCG
scaffold_78	reverse	TGCTGGAGAAGCCGGTTGGAGCAGAAGCTGGACTTGGGGCACCTCGCTTTGGTTAGGGTTAGGGTTAGGGTTAGGGTTAGGGTTAGGGTTAGGGTTAGGG
scaffold_82	reverse	AGCAGAGCGACAGACGGAACGGAAAGTGAGTAGGCGGAGAAGCGGCGACGAAACGCACTTAGGGTTAGGGTTAGGGTTAAGGTTAGGGTTAGGGTTAGGG
scaffold_86	reverse	CCGCGCAAAGCGCCAGAAATCGCGCTGTCTTCGGATGATCTTAGGGTTAGGGTTAGGGTTAGGGTTAGGGTTAGGGTTAGGGTTAGGGTTAGGGTTAGGG
scaffold_101	forward	CCCTAACCCTAACCCTAACCCTAACCCTAACCCTAACCCTAAAAGCAGACCTTGGCTGCTCAACTCACCCTCCTTCCACCCAGACCAGACGCGGTCAGCA
scaffold_106	forward	CCCTAACCCTAACCCTAACCCTAACCCTAACCCTAACCCTAACCCTAACCCTAACCCTAACCCTAACCCTAACCCCGGCTCTGCAAATCTCTCGCCCTCG

Telomeres found: 32 (18 forward, 14 reverse)
