scaffold_2	reverse	GCTTAGTCGCCTTTGTACTAGAACATCCTATGCGTAGACAAAAGGGTTAGGGTTAGGGTTAGGGTTAGGGTTAGGGTTAGGGTTAGGGTTAGGGTTAGGG
scaffold_4	forward	CCCTAACCCTAACCCTAACCCTAACCCTAACCCTAACCCTAACCCTAACCCTAACCCTAACCCTAACCTAACCCGTCAAGCGTACACTCGAGCCCTCGTA
scaffold_8	forward	CCCTAACCCTAACCCTAACCCTAACCCTAACCCTAACCCTAACCCTAACCCTAACCCTAACCCTTTACCCCTAATCCATAACCTGACCCTAAGCCTAACC
scaffold_13	reverse	CCCTTCTCTTGCTAACCATTCGGTTAGGGTTAGGGTTAGGTTAGGGTTAGGGTTAGGGTTAGGGTTAGGGTTAGGGTTAGGGTTAGGGTTAGGGTTAGGG
scaffold_17	reverse	GGTTATGAAAGGGGTCAGACTTGATCAGAGAGCGAGAAGGGTTAGGTTAGGGTTAGGGTTAGGGTTAGGGTTAGGGTTAGGGTTAGGGTTAGGGTTAGGG
scaffold_20	forward	CCCTAACCCTAACCCTAACCCTAACCCTAACCCTAACCCTAACCCTAACCCTAACCCTAACCCTAACCCTAACCGCAGGATCGAGTCAACCCGCGCACGT
scaffold_27	forward	CCCTAACCCTAACCCTAACCCTAACCCTAACCCTAACCCTAACCCTAACCCTAACCCTAACCCTAACCCTAACCCTAAACCCTAACCCTAACCCTAACCC
scaffold_33	forward	CCCTAACCCTAACCCTAACCCTAACCTAACCCTAACCCTAACCTAACCCTAACCCTAACCCTAAGCGGCCGAGGTTGACCGAGAGTTGCGTCCAAGCATC
scaffold_43	forward	CCCTAACCCTAACCCTAACCCTAACCCTAACCCTAACCCTAACCTAATCTAACCCTTACCCTAACCCTAACCTAACCTAACCTTCCGAAGCAGGTGCGAG
scaffold_45	reverse	GGTGTCCATGCAACACTTTGCCACCTCTACGTCGTCGCCCTTAGGGTTAGGGTTAGGGTTAGGGTTAGGGTTAGGGTTAGGGTTAGGGTTAGGGTTAGGG
scaffold_47	forward	CCCTAACCCTAACCCTAACCCTAACCCTAACCCTAACCCTAACCTAACCCTAACCCTAACCCTAACCCTAACCTAACCCTAAACCTAACCTATCCCCTCG
scaffold_49	forward	AACCCTAACCCTAACCCTAACCCTAACCCTAACCCTAACCCTAACCCTAACCCTAACCTAACATAACCGAGTCGTAGGGAGGGCAAGTTGGGCGTGCGAA
scaffold_51	reverse	TCTATAGTGCTCGTGGCTACACTCAGATGGTTAGGGTTAGGTTAGGGTTAGGTTAGGGTTATGGTTAGGGTTAGGGTTAGGGTTAGGGTTAGGGTTAGGG
scaffold_53	reverse	CACGTCGCCGTCGCCGCCGGGTGGTCTCCTTCTTGAAGGCGCCCTCTTAGGGTTAGGGTTAGGGTTAGGGTTAGGGTTAGGGTTAGGGTTAGGGTTAGGG
scaffold_58	forward	CCCTAACCCTAACCCTAACCCTAACCCTAACCCTAACCCTAACCCTAACCCTAACCTAACCTAACCAACGAGGGTCCAGACTGTGGCCCTAGCAGAATCG
scaffold_59	forward	CTAACCCTAACCCTAACCCTAACCCTAACCCTAACCCTAACCCTAACCCTAACCCTAACCCTAACCTAACCCTAACCGAGTTTCGAGTCCAGCCTGCGCT
scaffold_61	reverse	GGAACAGTTGTCAGTGTCGAAGGGTTAGGTTAGGGTTAGGTTAGGGTTAGGGTTAGGGTTAGGGTTAGGGTTAGGGTTAGGGTTAGGGTTAGGGTTAGGG
scaffold_66	forward	CCCTAACCCTAACCCTAACCCTAACCCTAACCCTAACCCTAACCCTAACCCTAACCCTAACCTAACCCTAAGCGAAAACGTAGTAAGCGCCACAGCAGCG
scaffold_74	reverse	TTTCCGTGCTATCAGGGCCTACAGGCAATCCAGACTTAGGGTTAGGGTTAGGTTAGGGTTAGGGTTAGGGTTAGGGTTAGGGTTAGGGTTAGGGTTAGGG
scaffold_83	reverse	CGCAAGCACTGCGTTTGTTAGGGTTAGGTCAGGGTTAGGGTTAGGGTTAGTGTTAGGGTTAGGGTTAGGGTTAGGGTTAGGGTTAGGGTTAGGGTTAGGG
scaffold_90	reverse	CAGAGGATCGAGGCGCTGTCCCTTCAAGGAGGAGACGGTTAGGGTTAGGGTTAGGGTTAGGGTTAGGGTTAGGGTTAGGGTTAGGGTTAGGGTTAGGGTT
scaffold_91	forward	CCCTAACCCTAACCTAACCCTAACCCCTAACCCTAACCCTAACCTAACCCTAACCCTAACCCTGGGCCCTGCCGGCTCTTCCAACCTTTGAACCTACATT
scaffold_93	forward	CCCTAACCCTAACCCTAACCCTAACCCTAACCCTAACCTAACCCTAACCCTAACCGCTAACCCTAACCCTAACCAGTTCGCCCCAGTAGCTGCGCGTGGG
scaffold_95	forward	ACCCTAACCCTAACCCTAACCCTAACCCTAACCCTAACCCTAACCCTAACCCTAACTAACCCTAACCTAACCCTAAGTTTTGAGTGCATTCCAAGCATAG
scaffold_99	forward	CTAACCCTAACCCTAACCCTAACCCTAACCCTAACCCTAACCCTAACCCTAACCCTAACCTAACCCTAACCCTAACCTAACCCTAACCCTAACCGGTTTC
scaffold_101	reverse	CATCTATGACTATGCAGGGACCTGGGCGCAACCGAGAGGTTAGGGTTAGGGTTAGGGTTAGGGTTAGGGTTAGGGTTAGGGTTAGGGTTAGGGTTAGGGT
scaffold_105	reverse	GTCTCAACGTCGGTGTACAGTACTCGGTTAGGGTTAGGGTTAGGGTTAGGGTTAGGGTTAGGGTTAGGGTTAGGGTTAGGGTTAGGGTTAGGGTTAGGGT
scaffold_109	forward	CCCTAACCCTAACCCTAACCCTAACCCTAACCCTAACCCTAACCATAACCCTAACACTAACCCTAACATAACACAAATTCGAGCTCCGTTGAACGGACAA
scaffold_110	reverse	AGACATTTAGGTTAGGGTTAGGGTTAGGGTTAGGTTAGGGTTAGGGTTAGGGTTAGGGTTAGGGTTAGGGTTAGGGTTAGGGTTAGGGTTAGGGTTAGGG
scaffold_113	forward	CCCTAACCCTAACCCTAACCCTAACCCTAACCCTAACCCTAACCTAACCCTAACCTAACCTAATCCCAATCTGCAGGCACCGCCGCTCACCGATGAAGGG

Telomeres found: 30 (17 forward, 13 reverse)
