scaffold_3	forward	CCCTAACCCTAACCCTAACCCTAACCCTAACCCTAACCCTAACCCTAACCCTAACCCTAACCCTACATGCCCAAGCTGCATGTTCTGAACTGGCCTACAC
scaffold_4	forward	CCCTAACCCTAACCCTAACCCTAACCCTAACCCTAACCCTAACCCTAACCCTAACCCTAACCCTAACCCTAACCCTAACCTAAGGCTGCCCCGATGCGAC
scaffold_6	forward	CCCTAACCCTAACCCTAACCCTAACCCTAACCCTAACCCTAACCTAACCCTAACCTAACCCTAAACCTAACCTATCCCCTCGCAAAAGAGCTGACAAAGT
scaffold_7	reverse	CTTCTATCTACAGAAGTTGGCCTGTTAGAGTCGGTTAGAGCTGTTAGGGCCGTTAGGGTTAGGGTTAGGTTAGGGTTAGGGTTAGGGTTAGGGTTAGGGT
scaffold_16	reverse	GCCCCGCCCATCGCCCGCTCATTTTTTAGGGTTAGGTTAGGGTTAGTTAGGGTTAGGGTTAGGGTCAGGGTTAGGGTTAGGGTTAGGGTTAGGGTTAGGG
scaffold_17	forward	CCCTAACCCTAACCCTAACCCTAACCCTAACCCTAACCCTAACCCTAACCTAACCCTAACCCTAACCGAATGGAGAGCAAGAGAAGGGAGAAAGGCGAGA
scaffold_20	reverse	TGCAGGGTTATGAAAGGGGTCAGACTTGATCAGAGAGCGAGAAGGGTTAGGGTTAGGGTTAGGGTTAGGGTTAGGGTTAGGGTTAGGGTTAGGGTTAGGG
scaffold_23	forward	AACCCTAACCCTAACCCTAACCCTAACCCTAACCCTAACCCTAACCCTAACCCTAACCCTAACCCTAACCCTAACCGCAGGATCGAGTCAACCCGCGCAC
scaffold_42	forward	CCCTAACCCTAACCCTAACCCTAACCCTAACCCTAACCCTAACCCTAACCCTTTACCCTTAATCCATAACCTGACCCTAAGCCTAACCCTAAGAGGGAAC
scaffold_46	forward	CCCTAACCCTAACCCTAACCCTAACCCTAACCCTAACCCTAACCCTAACCTAACCCTAACCATCTGAGTGTAGCCACGAGCACTATAGACGGCCACTCGA
scaffold_47	forward	CCCTAACCCTAACCCTAACCCTAACCCTAACCCTAACCCTAACCCTAACCCTAACCCTAAGAGCGCGCCTTCAAGAAGGAGACCACCCGGCGGCGACGGC
scaffold_54	forward	CCCTAACCCTAACCCTAACCCTAACCCTAACCCTAACCCTAACCCTAAACATAACCCTAACCCTAACCCTAACCTAACCCTAACCTAACCCTAAGCTCTG
scaffold_58	forward	CCCTAACCCTAACCCTAACCCTAACCCTAACCCTAACCCTAACCCTAACCCTAACCCTAACCCTAATCCTAACCCTAACCCTTCGACACTGACAACTGTT
scaffold_60	reverse	AGCACGCTGTTTCCCAGCAAGTAGGTTAGGTTAGGGTTAGGATAGGTTAAGGTTAGGGTTAGGGTTAGGGTTAGGGTTAGGGTTAGGGTTAGGGTTAGGG
scaffold_71	forward	CCCTAACCCTAACCCTAACCCTAACCCTAACCCTAACCCTAACCCTAACCCTAACCCTAACCTTACCCCTAATCCTAACCCTAAGTAACCCTAACCTAAC
scaffold_72	forward	CCCTAACCCTATCCCTAACCCTAACCCTAACCCTAACCTAACCTAACCTAGCATCTCTGGCTGAGGAGACCCGTCGAGTCAAAGGTGCTGCTGCCAGTTT
scaffold_79	forward	ACCCTAACCCTAACCCTAACCCTAACCCTAACCCTAACCCTAACCTAACCCTAACAAACGCAGTGCTTGCGGAAGAACGCGACAACCCTACATTTATAGC
scaffold_91	reverse	TGCGTTGGCGCTATGGTTAGGGTTATGGTTAGGATTAGGGTTAGGGTTAGGGTTAGGGTTAGGGTTAGGGTTAGGGTTAGGGTTAGGGTTAGGGTTAGGG
scaffold_93	reverse	AGCAAAGTGCTTCCCACCAAGGTTAGGGTTAGGGTTAGGGTTAGGGTTAGGGTTAGGGTTAGGGTTAGGGTTAGGGTTAGGGTTAGGGTTAGGGTTAGGG
scaffold_94	reverse	GCTCTCCTTACACACACCCGGATACGCTGGGCAAGCGGCTATGGGTTAGGGTTAGGGTTAGTGTTAGGTTAGGGTTAGGGTTAGGGTTAGGGTTAGGGTT
scaffold_97	forward	CCCTAACCCTAACCCTAACCCTAACCCTAACCCTAACCCTAACCCTAACCCTAACCCTAACCCTAACCCTTGCGCCAACCGGTCCCACATCCTCCGCTAG
scaffold_99	reverse	TGCACTCAAAACTTAGGGTTAGGGTTAGGTTAGGGTTAGGTTAGGGTTAGGGTTAGGGTTAGGGTTAGGGTTAGGGTTAGGGTTAGGGTTAGGGTTAGGG
scaffold_103	reverse	GAGTCTTAGGGGTTAGGTTAGGGTTAGGTTAGGGTTAGGGTTAGGGTTAGGGTTAGGGTTAGGGTTAGGGTTAGGGTTAGGGTTAGGGTTAGGGTTAGGG
scaffold_104	forward	CCCTAACCCTAACCCTAACCCTAACCCTAACCCTAACCCTAACCCTAACCCTAACCCTAACCTCTCGGTTGCGCCCAGGTCCCTGCATAGTCATAGATGC
scaffold_105	reverse	TCTATCCGATTCTGCTAGGGCCACAGTCTGGACCCTCGTTGGTTAGGTTAGGTTAGGGTTAGGGTTAGGGTTAGGGTTAGGGTTAGGGTTAGGGTTAGGG
scaffold_114	forward	CCCTAACCCTAACCCTAACCCTAACCCTAACCCTAACCCTAACCCTAACCCTAACACTAACCCTAACCTAACCCTAACCCTAACCTAACCCTAACCCTAA
scaffold_115	forward	CCCTAACCCTAACCCTAACCCTAACCCTAACCCTAACCCTAACCCTAACCCTAACCCTAACCCTAACCGAGTACTGTACACCGACGTTGAGACGAGAGTT
scaffold_120	reverse	TGCGTCGACGCTTGTCCGTTCAACGGAGCTCGAATTTGTGTTATGTTAGGGTTAGGGTTAGGGTTATGGTTAGGGTTAGGGTTAGGGTTAGGGTTAGGGT
scaffold_122	forward	CCCTAACCCTAACCCTAACCCTAACCCTAACCCTAACCCTAACCCTAACCTAACCTAACCCTAAACCTAACCCTAACCCTAACCCTAACCTAAATGTCTT
scaffold_123	forward	CCCTAACCCTAACCCTAACCCTAACCCTAACCCTAACCCTAACCCTAACCCTAAACCTAACCTAACCCTAACCTAACAGGCGTACAAACGCTTCTATTCG
scaffold_135	forward	CCCTAACCCTAACCCTAACCCTAACCCTAACCCTAACCCTAACCCTAACCCTAACCCTAACCTAACCTAACCGAGTCGTAGGGAGGGCAAGTTGGGCGTG
scaffold_179	forward	CCCTAACCCTAACCCTAACCCTAACCCTAACCCTAACCCTAACCCTAACCCTGAGCGCGGGGGCGGCGAGGGCAGCGGGCAGGTGTGGATGTGCGTCTGA

Telomeres found: 32 (21 forward, 11 reverse)
