scaffold_14	forward	CCCTAACCCTAACCCTAACCTAACCCTAACCCTAACCCTAACCCTGACCCTAGCCCTAACCCTAACCCTAACCGTAACCGTAACCGTTTGCCAGGTACGA
scaffold_28	reverse	TTAGGGTTAAGGTCAGGGGGAAGGTTAAAGCCAGGGTTAGGGTTAGGGTTAGGGTTAGGGTTAGGGTTAGGGTTAGGGTTAGGGTTAGGGTTAGGGTTAG
scaffold_34	reverse	CCCTCCTGAGTCCTGACAGTGCACAGCCAGTCAAGTCAATCAAAGGCTAACTTCTCCTTTCCAGACCAGGTTAGGGTTAGGGTTAGGGTTAGGGTTAGGG
scaffold_71	forward	CCCTAACCCTAACCCTAACCCTAACCCTAACCCTAACCCTAACCCTAACCCTAACCCTAGCCCTAGCCCTAACCCGAAAAGGGGGAGCAAGACTCCCTTG
scaffold_76	forward	CCCTAACCCTAACCCTAACCCTAACCCTAACCTTAACCCTAACCTAACCCTGACCCTAACCCTAACCCTAACCCTAACCCTAACCACATTCGCCTGGGCT
scaffold_89	forward	CCCTAACCCTAACCCTAACCCTAACCCTAACCCTAACCTAACCCTGACCCTAACCCTAACCCTAACCCTAACCCTAAGCGCTGGATGGGGGGAAAAGACA
scaffold_108	forward	CCCTAACCCTAACCCTAACCCTAACCCTAACCCTAACCCTAACCCTAACCCTAACCCTAAGAGACAAGGCATGCTTGCCAGGAGTACTGACTGCAATACC
scaffold_129	forward	CCCTAACCCTAACCCTAACCCTAACCTTAACCCTGACCCTAACCCTAACCCTAACCCTAACCCTAACCCTAACCCTAACCCTAACCCTAACCAAATTCGG
scaffold_135	forward	CCCTAACCCTAACCCTAACCCTAACCCTAACCCTAACCCTAACCCTAACCCTAACCCTGACCCTAACCCTAACCCTAACCCTAACCCTAACCCTAAGTTC
scaffold_139	forward	CCCTAACCCTAACCCTAACCCTAACCCTAACCCTAACCCTAACCCTAACCCTAACCCTAACCCTAACCCTAACCCTAACCCTAACCCTAACCTAAAAATG
scaffold_141	reverse	AGGGTTAGGGTTAGGGTTAGGGTTAGGGTTAGGATTAGGGTTAGGGTTAGGGTTAGGGTTAGGGTTAGGGTTAGGGTTAGGGTTAGGGTTAGGGTTAGGG
scaffold_149	reverse	TCGGTTAGGGTTAGGGTTAGGGTTAGGGTTAGGGTTAGGGTTAGGGTTAGGGTTAGGGTTAGGGTTAGGGTTAGGGTTAGGGTTAGGGTTAGGGTTAGGG
scaffold_151	forward	CCCTAACCCTAACCCTAACCCTAACCCTAACCCTAACGCTAACGCTAACGCGGTTTCGTTGGGAAAGCCATTAGGTTAGTTTTTGCTTGCTGCATGGACC
scaffold_152	reverse	TTAAGACGAGGATTAGGGTTAGGGTTAGGGTTAGGGTTAGGGTTAGGGTTAAGTTAGGGTTAGGGTTAGGGTTAGGGTTAGGGTTAGGGTTAGGGCTGTC
scaffold_166	reverse	GGGGGGAGCGCTCCCGAGAGAAGGGAGCTACCACAAATCCAAGCGAGAAGTTCTAACATTAGGGTTAGGGTTAGGGTTAGGGTTAGGGTTAGGGTTAGGG
scaffold_178	forward	CCCTAACCCTAACCCTAACCCTAACCCTAACCCTAACCCTAACCCTAACCCTAACCCTAACCCTAAGTTAGCAAGGGTTAAGAGTCCCTTTGGTCTGCGC
scaffold_184	forward	ACCTTAACCCTAACCCTAACCCTAACCCTAACCCTAACCCTAACCCTAACCCTAACCCTAACCCTAACCCTAACCAAAACCAAAAGTTAGAGAGTAAAAC
scaffold_188	forward	CCCTAACCCTAACCCTAACCCTAACCCTAACCCTAACCCTAACCTAACCCTAACCCTAACCCTAACCCTAACCCTAACCCTACCCCTAGCCTAACTCTAA
scaffold_196	forward	AACCCTAACCCTAACCCTAACCCTAACCCTAACCCTAACCCTAACCCTAACCCTAACCCTGGCCTTGACTTTAACCTTAGCCCTAACCCTAACCCTAACC
scaffold_206	reverse	GAACAGGAGGAAGAGGGTGAAGTCAAAGTTGGAGTTGGAACCGAAGGCAAGCTTAGGGTTAGGGTTAGGGTTAGGGTTAGGGTTAGGGTTAGGGTTAGGG
scaffold_227	reverse	GGTTAGAGTTAGAGTTAAGGTTAGGGTTAGGGTTAGGGTTAGGGTTAGGGTTAGGGTTAGGGTTAGGGTTAGGGTTAGGGTTAGGGTTAGGGTTAGGGTT
scaffold_270	reverse	TGTGACTTGGCTTAGAGTGCTTCTAGGGTTAGGGTTAGGGTTAGGGTTAGGGTCAGGGTTAGGGTTAAGGTTAGGGTTAGGGTTAGGGTTAGGGTTAGGG
scaffold_279	forward	CCCTAACCCTAACCCTAACCCTAACCCTAACCCTAACCCTAATCTTGACCTTGACCCTGACCCTAACTGGCGAGATAACCAAGTTTAAGGAACTCGGCAA
scaffold_292	reverse	GGGTTAGTTAGGTCAGGTCAGGTTAGGGTTAGGGTTAGGGTTAGGGTTAGGGGTAGGGGTAGGGTTAGGGTTAGGGTTAGGGTTAGGGTTAGGATTAGGG
scaffold_305	reverse	CTGGAATGACTTAGGGTTAGGGTTAGGGTTAGGGTTAGGGTTAGGATTAGGGTTAGGGTTAGGGTTAGGGTTAGGGTCAGGGTTAGGGTTAGGGTTAGGG
scaffold_321	reverse	CTGAGTGGGCCTCACCTTAGGGTTAGGGTTAGGGTTAGGGTTAGGGTTAGGGTTAGGGTTAGGGTTAGGGTTAGGGTTAGGGTTAGGGTTAGGGTTAGGG
scaffold_325	reverse	GGCTGGCCCACTTCAGCAGATCTTAGGGTTAGGGCTAGGGCCAGGGCTAGGGCTAGGGTTAGGGTTAGGGTTAGGGTTAGGGTTAGGGTTAGGGTTAGGG
scaffold_332	forward	CCCTAACCCTAACCCTAACCCTAACCCTAACCCTAACCCTAACCCTAACCCTAACCCTAACCCTCGTTCTAGCTCTAGCTCTAACCCTGACCCTGACCAG
scaffold_349	forward	CCCTAACCCTAACCCTAACCCTAACCCTAACCCTAACCCTAACCCTAACCCTGACTCTTCTCTTAACCTTAACCCTACTAACCCTAACCCTAAGGTGGTG
scaffold_386	forward	CCCTAACCCTAACCCTAACCCTAACCCTAACCCTAACCCTAACCCTGACCCTAACCCTAACCCTAGCCGCTTCTCGAGTCAGATCATCTCGCGCTTACAA

Telomeres found: 30 (17 forward, 13 reverse)
