scaffold_1	reverse	CTCGATACCCGCCTGGGCACGGGTTAGGGTTAGGGTTAGGTTAGGGTTAGGGCTAGGGTTAGGGTTAGGGTTAGGGTTAGGGTTAGGGTTAGGGTTAGGG
scaffold_7	reverse	CGCGAGTCTGTACGAGGGCTCGAGTGTACGCTTGACGACCTTAGGGTTAGGTTAGGGTTAGGGTTAGGGTTAGGGTTAGGGTTAGGGTTAGGGTTAGGGT
scaffold_8	reverse	TCGTCTCAACGTCGGTGTACAGTACTCGGTTAGGGTTAGGGTTAGGGTTAGGGTTAGGGTTAGGGTTAGGGTTAGGGTTAGGTTAGGGTTAGGGTTAGGG
scaffold_9	reverse	GCGAGGGGATAGGTTAGGTTTAGGGATAGGTTAGGTTTAGGGTTAGGTTAGGGTTAGGGTTAGGTTAGGGTTAGGGTTAGGGTTAGGGTTAGGGTTAGGG
scaffold_12	reverse	GGTGCGTTCCCTCTTAGGGTTAGGCTTAGGGTCAGGTTATGGATTAGGGGTAAAGGGTTAGGGTTAGGGTTAGGGTTAGGGTTAGGGTTAGGGTTAGGGT
scaffold_15	forward	CCCTAACCCTAACCCTAACCCTAACCCTAACCCTAACCCTAACCCTAACCCTAACCCTAACCCTAACCTAACCCTAACCCTAACCGAATGGAGAGCAAGA
scaffold_16	reverse	CCCATCGCCCGCTCATTTTTTAGGGTTAGGTTAGGGTTAGTTAGGATTAGGGTTAGGGTTAGGGTTAGGGTTAGGGTTAGGGTTAGGGTTAGGGTTAGGG
scaffold_17	forward	CCCTAACCCTAACCCTAACCCTAACCCTAACCCTAACCCTAACCTAACCTAACCCTAACCTAACCCTAACCCTAACCCTCGCCGCCTACGTGACCGTTCT
scaffold_20	forward	CCCTAACCCTAACCCTAACCCTAACCCTAACCCTAACCCTAACCCTAACCCTAACCCTAACCCTAACCTAACCCCTATCACCCTCCCACCCGTCTCCCAT
scaffold_21	reverse	GCGCGGGTTGACTCGATCCTGCGGTTAGGGTTAGGGTTAGGGTTAGGGTTAGGGTTAGGGTTAGGTTAGGTTAGGGTTAGGGTTAGGGTTAGGGTTAGGG
scaffold_28	reverse	TTAGGTTAGGGTTAGGTTAGGGTTAGGGTTATGGTTAGGGTTAGGGTTAGGGTTAGGGTTAGGGTTAGGGTTAGGGTTAGGGTTAGGGTTAGGGTTAGGG
scaffold_33	reverse	GACTGAAAGTGGAGCACACTGTTTCCCAGCAAGTAGGTTAGGTTAGGGTTAGGATAGGTTAGGGTTAGGGTTAGGGTTAGGGTTAGGGTTAGGGTTAGGG
scaffold_42	forward	CCCTAACCCTAACCCTAACCCTAACCCTAACCCTAACCCTAACCCTAACCCTAACCTAACCCTAAACCTAACCCTAACCCTAACCCTAAATTTTAACACT
scaffold_43	forward	CCCTAACCCTAACCCTAACCCTAACCCTAACCCTAACCCTAACCCTAACCCTAACCCTAACCTAACTCTAATCTAACCCTTACCCTAACCCTAACCTAAC
scaffold_45	forward	CCCTAACCCTAACCCTAACCCTAACCCTAACCCTAACCCTAACCCTAACCCTAACCCTAACCCTAACCCTAAGGGCGACGACGTAGAGGTGGCAAAGTGT
scaffold_46	reverse	TGCCATGTTCAAGACCCTTTCCTCGAGTTCTTAGGTTAGGGTTAGGGTTAGGTTAGGGTTAGGGTTAGGGTTAGGGTTAGGGTTAGGGTTAGGGTTAGGG
scaffold_49	forward	CCCTAACCCTAACCCTAACCCTAACCCTAACCCTAACCTAACCCTAACCCTAACCCTAAGGTCTCTATATCCTTTCTGGTCGAACCAGCGTAAACGCTAC
scaffold_50	forward	CCCTAACCCTAACCCTAACCCTAACCCTAACCCTAACCCTAACCCTAACCCTAACCCTAGCCCTAACCCTAACCCTAACCTAACCTAACCGAGTCGTAGG
scaffold_52	reverse	TGGCCGTCTATAGTGCTCGTGGCTACACTCAGATGGTTAGGGTTAGGTTAGGGTTAGGTTAGAGTTAGGGTTAGGGTTAGGGTTAGGGTTAGGGTTAGGG
scaffold_54	forward	CCCTAACCCTAACCCTAACCCTAACCCTAACCCTAACCCTAACCCTAACCCTAACCCTAACCCTAACCTAACCGACCCACGCTTGCCGCGCGACTGGACT
scaffold_60	forward	CCCTAACCCTAACCCTAACCCTAACCCTAACCCTAACCCTAACCCTAACCCTAACCCTAACCCTAACCCTGACCCTAACCTAATCTAACCTAACCCTAAC
scaffold_71	reverse	GGCAGCAGCACCTTTGACTCGACGGGTCTCCTCAGCCAGAGATGCTAGGTTAGGTTAGGTTAGGTTAGGGTTAGGGTTAGGGTTAGGGTTAGGGTTAGGG
scaffold_77	reverse	GGTGCAGGACAGTCAAGGCAATGCGGTTAGGGTTACTTAGGGTTAGGTTAGGGTTAGGGTTAGGTTAGGGTTAGGGTTAGGGTTAGGGTTAGGGTTAGGG
scaffold_78	forward	CCCTAACCCTAACCCTAACCCTAACCCTAACCCTAACCCTAACCCTAACCCTAACCCTAACCCTAACCATAGCGCCAACGCAAGATTTACACTAGGGGGC
scaffold_82	reverse	AAAGCTCGTCGACCAAAATGCTCGAGGGTTAGGGTTAGGGTTAGGGTTAGGGTTAGGGTTAGGGTTAGGGTTAGGGTTAGGGTTAGGGTTAGGGTTAGGG
scaffold_84	forward	CCCTAACCCTAACCTAACCCTAACCCTAACCCTAACCCTAACCCTAACCCTAACCCTAACCCTAGTCATAGATGCCTCCTGACGTTGCGAACCGTGGCGC
scaffold_91	reverse	CCTGTTAGCGCGGGAACAGTTGTCAGTGTCGAAGGGTTAGGTTAGGGTTAGGTTAGGGTTAGGGTTAGGGTTAGGGTTAGGGTTAGGGTTAGGGTTAGGG
scaffold_92	reverse	TTCTCTTCGACCAACTCTTTGTCTTAGGGTTAGGGTTAGGTTAGGGTTAGGGTTAGGGTTAGGGTTAGGGTTAGGGTTAGGGTTAGGGTTAGGGTTAGGG
scaffold_93	reverse	GGAAGCTCACGCACAGGTTAGGGTTAGGGTTAGGTTAGGGTTAGGGTTAGGGTTAGGGTTAGGGTTAGGGTTAGGGTTAGGGTTAGGGTTAGGGTTAGGG

Telomeres found: 29 (12 forward, 17 reverse)
