scaffold_1	forward	ACCCTAACCCTAACCCTAACCCTAACCCTAACCCTAACCCTAACCCTAACCCTAACCCTAACCCTAACCCTAACCATAGCGCCAACGCAAGATTTACACT
scaffold_4	reverse	TTTTTTCCTCGCACCTGCTTGGGGATTCTTAGGGTTAGGGTTAGGGTTAGGGTTATGGTTAGGGTTAGGGTTAGGGTTAGGGTTAGGGTTAGGGTTAGGG
scaffold_5	reverse	CCCACCAAGTGGTTAGGGTTAGGGTTAGGTTAGGGTTAGGTTAGGTTTAGGGTTAGGGTTAGGGTTAGGGTTAGGGTTAGGGTTAGGGTTAGGGTTAGGG
scaffold_7	forward	CCCTAACCCTAACCCTAACCCTAACCCTAACCCTAACCCTAACCCTAACCCTAACCCTAACCCTAACCCTAACCCTAACCTAAAATGAGCCCTAGCTTGA
scaffold_7	reverse	GAACGCGGTCCAAGTTTTGGAGGTTAGGGTTAGGTTAGGGTTAGGGTTAGGGTTAGGGTTAGGGTTAGGGTTAGGGTTAGGGTTAGGGTTAGGGTTAGGG
scaffold_8	reverse	GTCACTCGAAAAGTGTCTTAGGGTTAGGGTTAGGTTAGGGTTAGGGTTAGGGTTAGGGTTAGGGTTAGGGTTAGGGTTAGGGTTAGGGTTAGGGTTAGGG
scaffold_11	forward	CCCTAACCCTAACCCTAACCCTAACCCTAACCCTAACCCTAACCCTAACCTAACCCTAACCTAACCTAACCCTAACCTAACCCTAACACTTGACTGGCCT
scaffold_12	reverse	TGCGACGGCGGCTGTACTGCGCTTAGGGTTAGGGTTAGGGTTAGGGTTAGGGTTAGGGTTAGGGTTAGGGTTAGGGTTAGGGTTAGGGTTAGGGTTAGGG
scaffold_13	forward	CCCTAACCCTAACCCTAACCCTAACCCTAACCCTAACCCTAACCCTAACCCTAACTAACCTAACCCTAACCTAACCTGAACCAGCCCAATCTACGGCCAC
scaffold_14	reverse	AACAAATCGCAATTCTCCTCACCTTAGGTTTAGGGTTAGGGTTAGGTTAGGGTTAGGGTTAGGGTTAGGGTTAGGGTTAGGGTTAGGGTTAGGGTTAGGG
scaffold_15	reverse	TTTTTTCCTTGCACCTGCTTGGGGATTCTTAGGGTTAGGGTTAGGGTTAGGGTTAGGGTTAGGGTTAGGGTTAGGGTTAGGGTTAGGGTTAGGGTTAGGG
scaffold_20	forward	CCCTAACCCTAACCCTAACCCTAACCCTAACCCTAACCTAACCCTAACCCTAACCCTAACCCTAACCTAACCTAACCCTAACCTAACCTTCCTGTGCGCT
scaffold_23	reverse	GGGTTAGGGTTAGGGTTAGGGTTAGGGTTAGGGTTAGGGTTAGGGTTAGGGTTAAGGGTTAGGGTTAGGGTTAGGGTTAGGGTTAGGGTTAGGGTTAGGG
scaffold_25	forward	ACCCTAACCCTAACCCTAACCCTAACCCTAACCCTAACCCTAACCCTAACCCTAATCCTAACCCTAACCCTAACCCTAACCTAACCCTAACCCTAACCGA
scaffold_26	reverse	CATTTGACCATGCAGGTTAGGGGTTAGGTTAGGGTTAGGGTTAGGGTTAGGGTTAGGGTTAGGGTTAGGGTTAGGGTTAGGGTTAGGGTTAGGGTTAGGG
scaffold_27	reverse	CGAAAGTGTTCAGGAATACTGCGTGAGGCTGAGGGTTAGGTTAGGGTTAGGGTTAGGGTTATGGTTAGGGTTAGGGTTAGGGTTAGGGTTAGGGTTAGGG
scaffold_30	forward	CCCTAACCCTAACCCTAACCCTAACCCTAACCCTAACCCTAACCCTAACCTAACCCTAACCCTGACCCTAACCCTAACCCTAAGGACAGTGTGGCTGATC
scaffold_32	forward	ACCCTAACCCTAACCCTAACCCTAACCCTAACCCTAACCCTAACCCTAACCCCAACCCTAACCCTAACCCTAACCCTAACATAACACAAATTCGAGCTCC
scaffold_33	reverse	CTTTTTTGACTCGCTTCGGTAGGTTAGGGTTAGGTTAGGGTTAGGGTCAGGGTTAGGGTTAGGGTTAGGGTTAGGGTTAGGGTTAGGGTTAGGGTTAGGG
scaffold_35	forward	ACCCTAACCCTAACCCTAACCCTAACCCTAACCCTAACCCTAACCCTAACCCTAACCTAACCCTAACCCTACTGAAAGGCCCTTCTGCGCTACCGCTGGT
scaffold_37	reverse	GCTAGGTTAGTTTGGTTAGGGGGGTTAGGCTAGGTTAGGGTTAGGGTTATGGTTAGGGTTAGGGTTAGGGTTAGGGTTAGGGTTAGGGTTAGGGTTAGGG
scaffold_39	reverse	GTTGTTGCTGTTTTCGATACGGATTAGGTTAGGGTTAGGGTTAGGGTTAGGGTTAGGGTTAGGGTTAGGGTTAGGGTTAGGGTTAGGGTTAGGGTTAGGG
scaffold_41	forward	CCCTAACCCTAACCCTAACCCTAACCCTAACCCTAACCCTAACCCTAACCCTAACCCTAACCCTAAGTAACCCTAACCTAACCCTAGCCCGCCAAAACGC
scaffold_45	reverse	AGTCTGGACCCTCGTTGGTTAGGTTAGGGTTAGGTTAGGGTTAGGGTTAGGGTTAGGGTTAGGGTTAGGGTTAGGGTTAGGGTAACCCTAACCCTAACCC
scaffold_46	reverse	GCTCGGTTTTAGGGCCAGGGTTAGGGTTAGGTTAGGGTTAGGTTAGGTTAGGGGTTAGGTTAGGGTTAGGGTTAGGTTAGGGTTAGGGTTAGGGTTAGGG
scaffold_52	reverse	GCGGACATCAGTCTGCGCCAGAGGTTAGGTTAGGTTAGGGTTAGGGTTAGGGTTAGGGTTAGGGTTAGGGTTAGGGTTAGGGTTAGGGTTAGGGTTAGGG
scaffold_55	reverse	ACTGGTTAGGGTTAGGGTTAGGGTTAGGGTTAGGTTAGGGTTAGGGTTAGGGTTAGGGTTAGGGTTAGGGTTAGGGTTAGGGTTAGGGTTAGGGTTAGGG
scaffold_58	reverse	ACTCCCTGGGCTGAAACTGTTAGGTTAGGGTTAGGTTAGGGTTAGGTTAGGGTTAGGGTTAGGGTTAGGGTTAGGGTTAGGGTTAGGGTTAGGGTTAGGG
scaffold_61	reverse	GCTCATGTCAGCTCGGTGCCACCCTCGCCTTAGGGTTAGGTTAGGGTTAGGGTTAGGGTTAGGGTTAGGGTTAGGGTTAGGGTTAGGGTTAGGGTTAGGG
scaffold_65	reverse	TATGGTTAGGGTTAGGGTTAGGGTTAGGGTTAGGGTTAGGGTTAGGGTTAGGGTTAGGTTAGGGTTAGGGTTAGGGTTAGGGTTAGGGTTAGGGTTAGGG
scaffold_68	forward	CCCTAACCCTAACCCTAACCCTAACCCTAACCCTAACCATAACCTTAACCCTAACCCTAACCCTAACCCTAACCCTAACCTAACCTAACACTAAGCGGAA
scaffold_73	forward	CCCTAACCCTAACCCTAACCCTAACCCTAACCCTAACCCTAACCCTAACCCTAACCCTAACCCTAACCCTAACCCTAACCTTAACCTAACCCTACCCCTA

Telomeres found: 32 (12 forward, 20 reverse)
