scaffold_1	reverse	GGCATGCCCTCTTGCCGTCGTCGATTAGGTTAGGGTTAGGTTAGGGTTAGGGTTAGGGTTAGGGTTAGGGTTAGGGTTAGGGTTAGGGTTAGGGTTAGGG
scaffold_2	reverse	CACCTATACAGGTTTCGAGTTGGATTAGGTTAGGGTTAGGTTAGGGTTAGGGTTAGGGTTAGGGTTAGGGTTAGGGTTAGGGTTAGGGTTAGGGTTAGGG
scaffold_3	reverse	CGTCTTTTTGAGCCCTGAGCAAAGGGTTAGGGTTAGGTTAGGTTAGGTTAGGTTAGGGTTAGGGTTAGGGTTAGGGTTAGGGTTAGGGTTAGGGTTAGGG
scaffold_7	forward	CCCTAACCCTAACCCTAACCCTAACCCTAACCCTAACCCTAACCTTAACCCTAACCCTAACCTAACCCTAACCCTAACCCTAGCCACAGCGCCAACGCAA
scaffold_8	forward	ACCCTAACCCTAACCCTAACCCTAACCCTAACCCTAACCCTAACCCTAACCATAACCCTAACCTAACCGTTGTGCGAGTTCGGCATCAACTCGGCACCGG
scaffold_9	forward	CCCTAACCCTAACCCTAACCCTAACCCTAACCCTAACCCTAACCCTAACCCTAACCCTAACCCTAACCTAACCCTAAGTTCCTCCCCCTGCTCAACACCC
scaffold_17	reverse	AGGGTTAGGGTTAGGGTTAGGGTTAGGGTTAGGGTTAGGGTTAGGGTAAAGACAAGGGCTAGGGTTAGGGTTAGGGTTAGGGTTAGGGTTAGGGTTAGGG
scaffold_19	forward	CCCTAACCCTAACCCTAACCCTAACCCTAACCCTAACCCTAACCCTAACCCTAACCCTAACACCGATGCTGAAGTCGAGTTGTGTTCGGATGCTGCTGCA
scaffold_23	forward	CCCTAACCCTAACCCTAACCCTAACCCTAACCCTAACCCTAACCCTAACCCTAACCCTAACCATAACCCTAACCCTAACCCTAACCCTAACCCTAAACCT
scaffold_24	reverse	GCCCTCCTTCGGGTGAGGTTAGGTTTAGGTTAGGGTTAGGGTTAGGTTAGGGTTAGGGTTAGGTTAGGGTTAGGGTTAGGGTTAGGGTTAGGGTTAGGGT
scaffold_26	reverse	CTATATCCGCACGCTCGAAGGGTTAGGGTTAGGGTTAGGTTAGTGTTAGGGTTAGGGTTAGGGTTAGGGTTAGGGTTAGGGTTAGGGTTAGGGTTAGGGT
scaffold_28	forward	TAACTAACCTAACCCTAACCCTAACCCTAACCCTAACCCTAACCCTAACCCTAACCCTAACCCTAAACCTAACCCTAACCCTAACCTAACCCTAAGCCCT
scaffold_37	forward	CCCTAACCCTAACCCTAACCCTAACCCTAACCCTAACCCTAACCCTAACCCTAACCTTGTCCCTACCCCTAATCTTAACCCTAACCCTTTCACCCTAACT
scaffold_42	reverse	AGACTGCTTTCCCACCGAGTGGCGCTTCTTGTACTTAGGGTTAGGGTTAGGGTTAGGGTTAGGGTTAGGATTAGGGTTAGGGTTAGGGTTAGGGTTAGGG
scaffold_51	forward	CCCTAACCCTAACCCTAACCCTAACCCTAACCCTAACCCTAACCCTAACCCTAACCCTAACCCTAACCCTATTCCCTCATTTTGACCACGGGGAGTGTAA
scaffold_53	reverse	AACCGGTTACGGGTGCCATCGAGCGTTAGGTTAGGTTAGGGTTAGGTTAGGGTTAGGGTTAGGGTTAGGGTTAGGGTTAGGGTTAGGGTTAGGGTTAGGG
scaffold_59	forward	CCCTAACCCTAACCCTAACCTAACCCTAACCCTAACCCTAACCCTAACCCTAACCCTAACCCTAACCTAACCCTAACCTAAACCTAACCCGACGCCCGTC
scaffold_60	reverse	CCGACTCCATTCCTCGCTTAAGGTTAGGGTTAGGTCAGGGTTAGGGTTAGGGTTAGGGTTAGGGTTAGGGTTAGGGTTAGGGTTAGGGTTAGGGTTAGGG
scaffold_64	forward	CCCTAACCCTAACCCTAACCCTAACCCTAACCCTAACCCTAACCCTAACCCTAACCCTAACCCTAACCCTAACCTAACCCCGAGAAAAGGCGGTTCCGAC
scaffold_66	reverse	GAGGCCTCCCACCGCCACTATGTGTTAGGTTAGGGTTAGGGTTAGGTTAGGGTTAGGGTTAGGGTTATGGTTAGGGTTAGGGTTAGGGTTAGGGTTAGGG
scaffold_76	reverse	AGGGTTAGGGTTAGGACTAGGGTTAGGGTTAGGGTTAGGGTTAGGGTTAGGGTTAGGGTTAGGGTTAGGGTTAGGGTTAGGGTTAGGGTTAGGGTTAGGG
scaffold_79	forward	CCCTAACCCTAACCCTAACCCTAACCCTAACCCTAACCCTAACCCTAACCCTAAACCTAACCCTAACCCTAACCCTAACCTAACCCTAACCTAACCCTAA
scaffold_80	forward	CCCTAACCCTAACCCTAACCCTAACCCTAACCCTAACCCTAACCTAACCTAACCTAACCCTAACCTAACCTAACCTAACCCTAACGCCTCAACGATCCTT
scaffold_81	forward	CCCTAACCCTAACCCTAACCCTAACCCTAACCCTAACCCTAACCCTAAACCTAACCCTAACCCTAACCCTAACTCTAACTCAAGCAATGTGAAGACTGCA
scaffold_86	reverse	TGCCCTTTTCCGCTTCCGGTTAGGTTAGGTTAGGTTAGGGTTAGGGTTAGGGTTAGGGTTAGGGTTAGGGTTAGGGTTAGGGTTAGGGTTAGGGTTAGGG
scaffold_87	forward	AACCTAACCCCTAACCCTAACCCTAACCCTAACCCTAACCTAACCCTAACCCTAACCCTAACCCTAACCTGTACAAAGGGGCAGAGTATGCAGAAACAGG
scaffold_92	reverse	AGGCAATTTTGAGGCTGATGTGCTTAGGGTTAGGGTTAGGTTAGGGTTAGGGTTAGGGTTAGGGTTAGGGTTAGGGTTAGGGTTAGGGTTAGGGTTAGGG
scaffold_95	reverse	CAAGATCGTGCACCCGCAACCGCTTAGGTTAGGGTTAGGGTTAGGTTAGGGTTAGGGTTAGGGTTAGGGTTAGGGTTAGGGTTAGGGTTAGGGTTAGGGT
scaffold_106	forward	CCCTAACCCTAACCCTAACCCTAACCCTAACCCTAACCCTAACCCTAACCCTAACCCTAACCCTAACCTAACCCTAACCTAACCCTTTGTCCAGAATGGG
scaffold_121	forward	CCCTAACCCTAACCCTAACCCTAACCCTAACCCTAACCCTAACCTAACCCTAACCCTAACCTAACCTAACCTAACCCTAACCCTAAGCGTCCCTTCCGAA
scaffold_122	reverse	AAGGGAAATGGAGAGGAAGTGCTTAGGATTAGGGTTAGGGTTAGGGTTAGGGTTAGGGTTAGGGTTAGGGTTAGGGTTAGGGTTAGGGTTAGGGTTAGGG
scaffold_124	forward	CCCTAACCCTAACCCTAACCCTAACCCTAACCCTAACCTAACCCTAACCCTAACCCTAGTCTTAATATTAACCCTAACCCTAACCCTAGTGTTAACCCTG
scaffold_125	reverse	TAGGGTTAGGTTAGGGTTAGGGCTAGGATTAGGGCTAGGGTTAGGGTTAGGGTTAGGGTTAGGGTTAGGGTTAGGGTTAGGGTTAGGGTTAGGGTTAGGG
scaffold_129	forward	CCCTAACCCTAACCCTAACCCTAACCCTAACCCTAACCCTAACCATAACCCTAACCCTAACCTAACCCTAACCCTAAGCACAATCTTGAATCTCGGAGCC
scaffold_135	reverse	GATGTGAGGTTAGGGTTAGGGTTAGGGTTAGGGTTAGGGCTAGGGTTAGGGTTAGGTTAGGGTTAGGGTTAGGGTTAGGGTTAGGGTTAGGGTTAGGGTT
scaffold_137	forward	CCCTAACCCTAACCTAACCCTAACCCTAACCCTAACCCTAACCCTAACCCTGACCTAACCCTAACCTAACCCTAACCTAACGGAAACAAGTCCGATTCGC
scaffold_142	reverse	CAGAGCAAAAGTGAGCTTAGGGCTAGGGTTAGGGTCAGGGTTAGAGTCAGGGTTAGGGTTAGGGTTAGGGTTAGGGTTAGGGTTAGGGTTAGGGTTAGGG
scaffold_151	reverse	AGTACTGTCGGACGGAAGGGTTAGGTTAGGGTTAGGTTAGGGTTAGGTTAGGGTTAGGTTAGGGTTAGGGTTAGGGTTAGGGTTAGGGTTAGGGTTAGGG
scaffold_153	reverse	TACAGTACTGACTGGTGACGTCTTGCTGGTTAGGGTCAGGGTTAGGGTTAGGGTCAGGTTAGGGTTAGGGTTAGGGTTAGGGTTAGGGTTAGGGTTAGGG
scaffold_157	reverse	GGCGGCTATGCGGCTGGGGACCGCGTTAGGGTTAGGGTTAGGTTAGGGTTAGGGTTAGGTTAGGGTTAGGGTTAGGTTAGGGTTAGGGTTAGGGTTAGGG
scaffold_162	forward	GGGTTAGGGTTAGGGTTAGGGTTACCCTAACCCTAACCCTAACCCTAACCCTAACCCTAACCTTAACCCTAACCCTAATCTAACCCTAACCCTAACCTAA
scaffold_164	reverse	TTCCAATCCGGATTTGCTATATAGAAGCTTAGGGTTAGGGTTAGGGTTAGGGTTAGGGTTAGGGTTAGGGTTAGGGTTAGGGTTAGGGTTAGGGTTAGGG
scaffold_166	forward	CCCTAACCCTAACCCTAACCCTAACCCTAACCCTAACCCTAACCCTAACCCTAACCCTAACCCTAAGTTGTGAGGGGAACGCTCTGTCCGGAGTGAGGAA
scaffold_167	forward	CCCTAACCCTAACCCTAACCCTAACCCTAACCCTAACCCTAACCCTAACCCTAACCCTAACCCTAACCCTAACCCTAACCTTGGGCGAGGTTCCGAGGAG
scaffold_170	forward	CCCTAACCCTAACCCTAACCCTAACCCTAACCCTAACCCTAACCCTAACCCTAACCCTAACCCTAACCCTAACCTATTCGGGGCAGAGGTGAAAATCAAA
scaffold_175	forward	GTCTTTCACCCACCCCATTCAGCTTGACAGGGTGTGGACCATGGCTGCAGTCCCCGCCGAGCACCTGGCTGATATGGGTCAAAGACCCTAACCCTAACCC
scaffold_180	forward	CCCTAACCCTAACCCTAACCCTAACCCTAACCCTAACCCTAACCCTAACCCTAACCCTAACCCTAACCTAACCTAACCTTGCAACACAACCTATGAAAGG
scaffold_195	forward	CCCTAACCCTAACCCTAACCCTAACCCTAACCCTAACCCTAACCCTAACCCTAACCCTAGCCCTAACTCTAACCTAACCCTAACCCTAACCTGGAGAATG
scaffold_198	forward	CCCTAACCCTAACCCTAACCCTAACCCTAACCCTAACCCTAACCCTAACCTAACCCTAACCCTAAGTCTGACTCAGTTGGAGGTGCAGAACTGTCGTGGT
scaffold_207	reverse	TTCGCTTCGACCGTTGCTCTTAGGGTTAGGTTAGGGTTAGGTTAGGGTTAGGTTTAGGGTTAGGGTTAGGTTAGGGTTAGGGTTAGGGTTAGGGTTAGGG
scaffold_212	forward	AACCCTAACCCTAACCCTAACCCTAACCCTAACCCTAACCCTAACCCTAACCCTAACCCTAACCCTAACCCTAACCCTAACCCTAACCCTAACCTGTTTG
scaffold_213	reverse	TTCTTAGGTTAGGTTAGGGTTAGGTTAGGGTTAGGTTAGGGTTAGGTTAGGGTTAGGTTAGGGTTAGGGTTAGGGTTAGGGTTAGGGTTAGGGTTAGGGT
scaffold_215	forward	ACCCTAACCCTAACCCTAACCCTAACCCTAACCCTAACCCTAACCCTAACCCTAACCCTAACCCTAACCCTAACCCTAACCCTAACCCTAACCAGGTTCA
scaffold_216	forward	CCCTAACCCTAACCCTAACCCTAACCTAACCTAACCCTAACCCTAACCCTAACCCTAACCCTAACCCTAACCCTAACCCTAACCCTTAACGGACGCAGAG
scaffold_225	reverse	TTGCTGATCATGGCGGTGTCTGGTTAGGTTAGGGTTAGGGTTAGGGTTAGGGTTAGGGTTAGGGTTAGGGTTAGGGTTAGGGTTAGGGTTAGGGTTAGGG
scaffold_237	reverse	ACTTAGGGTTAGGGTTAGGGTTAAATTAGGGTTAGGTTAGGTTAGGATTAGGCTAGGGTTAGGGTTAGGGTTAGGGTTAGGGTTAGGGTTAGGGTTAGGG
scaffold_243	reverse	AGGGTCAAGGTTAAGGTCAAGGTCAGGGTTAGGGTTAGGGTTAGGGTTAGGGTTAGGGTTAGGGTTAGGGTTAGGGTTAGGGTTAGGGTTAGGGTTAGGG
scaffold_249	reverse	TTAGGTTAGGGTTAGGTTAGGGTTAGGGTTAGGTTTAGGGTTAGGGTTAGGGTCAGGGTTAGGGTTAGGGTTAGGGTTAGGGTTAGGGTTAGGGTTAGGG
scaffold_253	reverse	TGCCCGAGCAGCGTGGCTCTCTCTCTCGGGTTAGGGTTAGGTTAGGGTTAGGGTTAGGTTAGGGTTAGGGTTAGGGTTAGGGTTAGGGTTAGGGTTAGGG
scaffold_258	forward	AACCCTAACCCTAACCCTAACCCTAACCCTAACCCTAACCCTAACCCTGACCCTAACCTAACCCTAACCTAACTAACCTAACCCTAACCTAAGATGGTCG
scaffold_354	forward	AACCCTAACCCTAACCCTAACCCTAACCCTAACCCTAACCTAACCCTAACCCTAACCCTAACCCTAACCCTAACCCTAACCTAAGGCTCTGAGACTGAAG

Telomeres found: 61 (32 forward, 29 reverse)
