scaffold_3	forward	CCCTAACCCTAACCCTAACCCTAACCCTAACCCTAACCCTAACCCTAACCCTAAGTTGCGTCTCAGGGGCAGTGCTAGCCCCGGAGGAAGGAGCGGAGGC
scaffold_6	forward	CCCTAACCCTAACCCTAACCCTAACCCTAACCCTAACCCTAACCCTAACCCTAACTCTAATCCGCAGCAAGTGCAGACCCCGCAGCAGCAGCAGCTTGCC
scaffold_17	reverse	GTCATCGGCATCCGGTCGCAGTAAACGTCTCAGGGCTAGGTTAGGGTTAGGGTTAGGGTTAGGGTTAAGGTTAGGGTTAGGGTTAGGGTTAGGGTTAGGG
scaffold_29	forward	CCCTAACCCTAACCCTAACCCTAACCCTAACCCTAACCCTAACCCTACCCCTAACCCTATAACCCTAACCTAAATTTGCGTGGCAGTCAGATTGGCCGTC
scaffold_36	forward	ACCCTAACCCTAACCCTAACCCTAACCCTAACCCTAACCCTAACCCTAACCCTAACCCTAACCCTAAGGTCAAAGCAAAGGAGCAGCGTCACATGCCAAC
scaffold_41	reverse	TTTCCCCTTCCTCTATCCTCTGGTGCTCTCTTTCCTAGGGTTAGGGTTAGGGTTAGGGTTAGGGTTAGGGTTAGGGTTAGGGTTAGGGTTAGGGTTAGGG
scaffold_53	reverse	ATTTTGTGCGGTACTTGCATGTGCTTAGGGTTAGGTTAGGGTTAGGGTTAGGGTTAGGGTAGGGTTAGGGTTAGGGTTAGGGTTAGGGTTAGGGTTAGGG
scaffold_57	forward	CCCTAACCCTAACCCTAACCCTAACCCTAACCCTAACCCTAACCCTAACCCTAACCCTAACCCTAACCCTAACCCTAACCCTAAGTTGCATGTGCAAGCG
scaffold_62	forward	CCCTAACCCTAACCCTAACCCTAACCCTAACCCTAACCCTAACCCTAACCCTAACCCTAACCCTAACGCTAACGAGGACGAGGCGCGGAGACTCGCCGCG
scaffold_64	forward	CCCTAACCCTAACCCTAACCCTAACCCTAACCCTAACCCTAACCCTAACCCTAACCCTAAGTCTGATGGTACCCTAACTGGCCCCCTAACTGGCTGGCCC
scaffold_67	reverse	TTAGGGCACCATCAGACTCTGAAAAATGCACAATATCAGGTTAGGGTTAGGGTTAGGGTTAGGGTTAGGGTTAGGGTTAGGGTTAGGGTTAGGGTTAGGG
scaffold_68	reverse	CTGTCACCTGGCGCAACTTAGGTTAGGGTTAGGGTTAGGGTTAGGGTTAGGGTTAGGGTTAGGGTTAGGGTTAGGGTTAGGGTTAGGGTTAGGGTTAGGG
scaffold_70	reverse	CGCGAGAAGACGCAACTTAGGGTCAGGGTTAGGTTCAGGGTTAGGGTTAGGGTTAGGGTTAGGGTTAGGGTTAGGGTTAGGGTTAGGGTTAGGGTTAGGG
scaffold_71	forward	CCCTAACCCTAACCCTAACCCTAACCCTAACCCTAACCCTAACCCTAACCCTAACCCTAACCCTAACCCTTTCGCACCAAGAACAAGCATGAAAAGGGGC
scaffold_78	reverse	ACGGTTGTCACTAGGGTTAGGGTTAGGGTCAAGGTTAGGGTTAGGGTTAGGGTTAGGGTTAGGGTTAGGGTTAGGGTTAGGGTTAGGGTTAGGGTTAGGG
scaffold_82	reverse	ACATTGGATACCTCGGCACCGATATCAACTCGTACACGCCTTAGGGTTAGGGTTAGGGTTAGGGTTAGGGTTAGGGTTAGGGTTAGGGTTAGGGTTAGGG
scaffold_84	forward	CCCTAACCCTAACCCTAACCCTAACCCTAACCCTAACCCTAACCCTAACCCTAACCCTAACCCTAACCCTGAGGCAGGTTGCAACATCAAGACAGAACCG
scaffold_90	reverse	GGGCGGGGAGGCCGGCGGCGTCGTCGAGCTGGTGGTTAGGGGTAGGTTAGGGTTAGGGTTAGGGTTAGGGTTAGGGTTAGGGTTAGGGTTAGGGTTAGGG
scaffold_94	forward	CCCTAACCCTAACCCTAACCCTAACCCTAACCCTAACCCTAACCCTAACCCTAACCCTCAGTATTTCTGGCGCGAAAGCTTGTCCCGATTTCCCTTCCCT
scaffold_103	reverse	AGCGAGTCTCTTTGCTTGATCTATGCGGTAAGGGTTAGGGTTAGGGTTAGGGTTAGGGTCAGGGTTAGGGTTAGGGTTAGGGTTAGGGTTAGGGTTAGGG
scaffold_107	reverse	GGCACCGAGGTTAGGGTCAGGGTTAGGGTTAGGGTTAGGGTTAGGGTTAGGGTTAGGGTTAGGGTTAGGGTTAGGGTTAGGGTTAGGGTTAGGGTTAGGG
scaffold_108	forward	CCCTAACCCTAACCCTAACCCTAACCCTAACCCTAACCCTAACCCTAACCCTAACCCCCAGTCTGGCACGACGCGCTTGACGTCCTCGACCGCGCCGTCG
scaffold_117	reverse	AGCCGGTGGTAGAAGAGCCGGTGCTGGCTCATTGGGCGAGGTGGTGTTAGGGTTAGGGTTAGGGTTAGGGTTAGGGTTAGGGTTAGGGTTAGGGTTAGGG
scaffold_119	reverse	TGCTTGCAGCTCCCGACTGCGCAACTCACGAGTTAGGGTTAGGGTTAGGGTTAGGGTTAGGGTTAGGGTTAGGGTTAGGGTTAGGGTTAGGGTTAGGGTT
scaffold_123	forward	AACCCTAACCCTAACCCTAACCCTAACCCTAACCCTAACCCTAACCCTAACCCTAACCCTAACCCTAACCCTGACCCTCGTCAACTCGCAGACGGTCGTC
scaffold_181	forward	CCCTAACCCTAACCCTAACCCTAACCCTAACCCTAACCCTAACCCTAACCCTAACCCTAACCCTAACCCTAACCCTAACCCTAACCCTAACCCTAACCCT
scaffold_199	reverse	TAGTCTTCTTAGGGTTAAGGGTTAGGGTTAGGGTCAGGGTTAAGGATTAGGATTAGGGTTAGGGTTAGGGTTAGGGTTAGGGTTAGGGTTAGGGTTAGGG
scaffold_204	reverse	GACTAGCGAAAGGGCTTTCGACACGCGCCTCTCCTGAAGCTGCCTTCCTCCTCGACGTTCTTCCAGCCTTTCCTGGCGCTTCTTAGGCGGTTAGGGTTAG

Telomeres found: 28 (13 forward, 15 reverse)
