scaffold_2	forward	CCCTAACCCTAACCCTAACCCTAACCCTAACCCTAACCCTAACCCTAACCCTAACCCTAACCCTAACCCTAACACTAACCCTAAGTTTTCCGAGGCTTGC
scaffold_3	forward	CCCTGACCCTAACCCTAACCCTAACCCTAACCCTAACCCTAACCCTAACCCTAACCCTAACCCTAACCCTAACCTAACCCTAAATCGAAATCTTGACAAA
scaffold_4	reverse	TGCCCTGTTTCTGTATACTCTTTGGGGTTAAGGGTTAGGGTTAGGGTTAGGGTTAGGTTAGGGGTTAGGGTTAGGGTTAGGGTTAGGGTTAGGGTTAGGG
scaffold_12	forward	AACCCTAACCCTAACCCTAACCCTAACCCTAACCCTAACCCTAACCCTAACCCTAACCCTAACCCTAACTTCTTGACTACCGGGGTCCAGACTATAGCTC
scaffold_14	reverse	ATCACGTCGTCGTATCGTCGCAGGAGGTTAGGGTTAAGGTTAGGGTTAGGGTTAGGGTTAGGGTTAGGGTTAGGGTTAGGGTTAGGGTTAGGGTTAGGGT
scaffold_17	reverse	CGGACTTGCACGCAGAGTTTTAGGGTTAGGTTAGGGTTAGGTTAGGGTTAGGTTAGGGTTAGGGTTAGGGTTAGGGTTAGGGTTAGGGTTAGGGTTAGGG
scaffold_20	reverse	CCTGCCTTGAAGGTGCTACCCTTTAGGGTTAGGGTTAGGGTTAGGGTTAGGGTTAGGGTTAGGGTTAGGGTTAGGGTTAGGGTTAGGGTTAGGGTTAGGG
scaffold_21	reverse	TTTTCTTAGGGTTAGGTTAGGGTTAGGGTTAGGGTTAGGATTAGGGTTAGGGTTAGGGTTAGGGTTAGGGTTAGGGTTAGGGTTAGGGTTAGGGTTAGGG
scaffold_46	forward	CCCTAACCCTAACCCTAACCCTAACCCTAACCCTAACCCTAACCTAACCCTAACCCTAACCCTAACCTAACCCTAACCCTAACCCTAAGTCACTATAGTC
scaffold_49	forward	CCCTAACCCTAACCCTAACCCTAACCCTAACCCTAACCCTAACCCTAACCCTAACCCTAACCTAACCCTAACCCTAACCTAACCCAAAGTGGACGAGGAC
scaffold_52	forward	CCCTAACCCTAACCCTAACCCTAACCCTAACCCTAACCCTAACCCTAACCTAACCCTAACCCTAACCCTAACTTTTTGACCATGTGGATACAGTCATGAG
scaffold_54	reverse	AGGAGCTGGCCTTAGGGTTAGGGTTAGGGTTAGGGTTAGGTTAGGGTTAGGGTTAGGGTTAGGGTTAGGGTTAGGGTTAGGGTTAGGGTTAGGGTTAGGG
scaffold_55	reverse	GATCTCGGACCCGGGCCTAGGGTTAGGGTTAGGGTTAGGGTTAGGGTTAGGGTTAGGGTTAGGGTTAGGGTTAGGGTTAGGGTAACCCTAACCCTAACCC
scaffold_61	reverse	GTTCTCTCACTTGCCTTTTCGCTTCGCTCTTAGGGTTAGGGTTAGGTTAGGGTTAGGGTTAGGGTTAGGGTTAGGGTTAGGGTTAGGGTTAGGGTTAGGG
scaffold_72	reverse	CTCCTTTCAGGTGAGTGCTTGTCTCTATTTTACGCGTTCGCTTAGGGTTAGGTTAGGGTTAGGGTTAGGGTTAGGGTTAGGGTTAGGGTTAGGGTTAGGG
scaffold_78	forward	CCCTAACCCTAACCCTAACCCTAACCCTAACCCTAACCCTAACCCTAACCCTAACCCTAACCCTAACCCTAACCCTAACCTAACCCTAAGCTCCGCAACA
scaffold_86	forward	CCCTAACCCTAACCCTAACCCTAACCCTAACCCTAACCCTAACCCTAACCCTAACCCTAACCCTAACCCTAACCCTAACCTAAGACTGCTCGTCTTGCTC
scaffold_88	reverse	TAGGTTTTGGGTTAGGGTTAGGTTAGGGTTAAGGTTAGGGTTAGGGTTAGGGTTAGGGTTAGGGTTAGGGTTAGGGTTAGGGTTAGGGTTAGGGTTAGGG
scaffold_89	reverse	GCTCGAGAGATCGCTCCGGTGCGGTACGTTAGGGTTAGGGTTAGGGTTAGGGTTAGGGTTAGGGTTAGGGTTAGGGTTAGGGTTAGGGTTAGGGTTAGGG
scaffold_90	reverse	TGTCCCTCGGCTTTTTGGAGGCCACATTGGACCTCTTAGGGTTAGGGTTAGGGTTAGGGTTAGGTTAGGGTTAGGGTTAGGGTTAGGGTTAGGGTTAGGG
scaffold_93	forward	CCCTAACCCTAACCCTAACCCTAACCCTAACCCTAACCCTAACCCTAACCCTAACCTAACCCTAACCGGTTCAAGACAAGACAAGCCCGGGGAACCTTTG
scaffold_96	reverse	AGCTGTTACATCTTAGGTTAGGGTTAGGTTAGGGTTAGGGTTAGGGTTAGGGTTAGGGTTAGGGTTAGGGTTAGGGTTAGGGTTAGGGTTAGGGTTAGGG
scaffold_98	forward	CCCTAACCCTAACCCTAACCCTAACCCTAACCCTAACCCTAACCCTAACCCTAACCCTAAGAAACTTGCACCAAGCAGGTCAAAGCGAGATGCAGAGGCG
scaffold_112	reverse	GGGACGTTTTTGTGGAATTTTGACTGAACACGGACCTTAGGGTTAGGTTAGGGTTAGGTTAGGGTTAGGGTTAGGGTTAGGGTTAGGGTTAGGGTTAGGG
scaffold_113	reverse	GGTTAGGTTACTTAGGTTATGGTTAGGGTTATGGTTAGAGTTAGGGTTAGGGTTAGGGTTAGGGTTAGGGTTAGGGTTAGGGTTAGGGTTAGGGTTAGGG
scaffold_114	forward	CCCTAACCCTAACCCTAACCCTAACCCTAACCCTAACCCTAACCCTAACCCTAACCCTAACCCTAACCCTAACCCTAACCCTAACCCTAGCCCTAACCTA
scaffold_116	forward	ACCCTAACCCTAACCCTAACCCTAACCCTAACCCTAACCCTAACCCTAACCCTAACCCTAACCCTAACCCTAACCCTAACCCTAACCTAACCCTTTTCGG
scaffold_117	forward	CCCTAACCCTAACCCTAACCCTAACCCTAACCCTAACCCTAACCCTAACCCTAACCCTAACCCTAAAAATTGAGTGCACAGCCACCAAGCGAGTGGCAAG
scaffold_119	forward	CCCTAACCCTAACCTAACCCTAACCCTAACCCTAACCCTAACCCTAACCCTAACCCTAACCCTAACCTAACACGGCATCGCCCTCACGCACTCGACCAAT
scaffold_120	reverse	GCTCGCCATCCGCAGCATGGGGTTAGGGTTAGGGTTAGGGTTAGGGTTAGGGTTAGGGTTAGGGTTAGGGTTAGGGTTAGGGTTAGGGTTAGGGTTAGGG
scaffold_121	forward	CCCTAACCCTAACCCTAACCCTAACCCTAACCCTAACCCTAACCCTAACCCTAACCCTAACCCTAACCCTAACTACTACCCGGCCAAGCTCGTGGCGGAA
scaffold_161	forward	CCCTAACCCTAACCCTAACCCTAACCCTAACCCTAACCCCTAACCTAACCCTAACCTAACCCTAACCTAACCCTAACCTAACCCTTTGCGCCATCCAGAA

Telomeres found: 32 (16 forward, 16 reverse)
